Gs^Fds, Gs^Fds, Gg^Efm, Gg, Ce, Gs^Fds, Gs^Fds, Hh^Em, Hh, Ww^Ewl, Ww, Wo, Gs^Fms, Mm, Hh, Gg^Efm, Gs^Efm, Gg, Gg, Gs^Fds, Gd^Em, Ce
Hh^Fds, Gs^Fmw, Gd^Em, Ce, Ket, Gg^Efm, Ce, Gs^Fmw, Mm^Xm, Hh, Wwf^Dr, Ww^Wkf, Ww^Ewf, Gs^Fds, Ww, Wwf^Es, Hh^Fms, Gs^Fds, Gg^Fet, Gs^Wm, Gs^Fds, Hh^Fms
Gg, Gs^Es, Hh^Fds, Gs, Gg, Gs^Fmw, Hh, Gs, Mm, Hh^Em, Hh^Em, Wwf, Ww^Wkf, Ww^Wkf, Wo, Ww, Wwr, Hh^Fds, Gs^Vh, Gg^Efm, Ce, Ce
Gs^Fds, Gg^Fet, Hh^Fms, Hh^Fms, Gg^Efm, Gg, Gs^Em, Gd^Emf, Gs^Fmw, Mm, Hh, Wwf, Gs^Fds, Wwr, Hh, Wo, Ww^Wkf, Hh^Em, Gs^Em, Gg^Efm, Gs^Fds, Ket
Gs^Efm, Gs^Fmw, Gs, Gs^Fds, Gs, Gs^Fmw, Hh^Fds, Gs^Em, Gs, Gs^Fds, Gg^Es, Gg^Ii, Gs, Gs^Fds, Gg^Efm, Ww^Bw/r, Ww^Dr, Ww, Hh^Fms, Gg, Mm, Hh
Gs^Fms, Gg, Gg^Ve, Gs^Em, Gd^Emf, Gs^Em, Gg, Gg^Wm, Gg, Gg, Gg, 1 Gs^Efm, Gg^Efm, Gg, Gs^Fms, Wwf, Wwr, Gg, Ww, Ww, Wo, Wwf
Mm, Hh^Fds, Hh^Em, Mm, Hh, Gs^Fds, Gs^Fds, Gs^Efm, Gs^Vl, Gs, Gs, Gg, Gs, Gs^Wm, Gs^Fds, Hh^Fds, Gs, Gs^Fds, Wwf, Wwr, Ww^Wkf, Ww^Ewf
Hh, Mm^Xm, Mm, Mm^Xm, Mm, Hh^Fds, Gg, Gg^Es, Gs^Fms, Gg^Efm, Gs, Gd, Ce, Gs, Gg, Gg^Efm, Gg^Fet, Gd^Em, Gs^Es, Gg, Gs^Fds, Gs^Fms
Hh^Fds, Mm, Mm, Mm^Xm, Mm, Hh, Gs, Ww, Ww^Ewf, Ce, Ww, Gs^Fmw, Ce, Ket, Gs^Efm, Gs^Fds, Gs^Fds, Gs^Fms, Mm, Mm, Mm^Xm, Gg
Hh^Fdw, Mm, Mm, Mm, Mm, Mm, Gd^Emf, Wwr, Wwf, Ww^Wkf, Wo, Gs^Fms, Gs, Gg, Gs^Fmw, Hh, Hh^Fdw, Hh^Em, Mm, Mm, Mm, Hh^Em
Mm, Mm, Hh^Fds, Hh^Fdw, Mm^Xm, Hh^Em, Hh^Fds, Gs^Em, Gg, Ww^Ewf, Gg^Efm, Gs^Es, Gd, Gs^Fds, Hh^Fds, Mm, Mm, Mm, Mm, Mm, Mm^Xm, Hh
Mm, Mm, Hh, Mm, Mm, Mm, Mm, Mm, Gs^Fds, Gg^Efm, Gg, Gs^Fmw, Hh^Fds, Gs, Hh, Mm^Xm, Mm, Mm, Gg, Hh^Fdw, Mm, Mm^Xm
