Wo, Wo, Wo, Wo, Ww, Ww, Wwr, Wwr, Wwr, Wo, Wo, Wo, Wo, Wo, Wo, Wo, Wo, Wo, Wo, Wo, Wo, Wo, Wo, Wo, Wo, Wo, Wo, Wo, Wo, Wo, Wo, Wo
Wo, Wo, Wwr, Ww, Ds, Ww, Wwf, Wwr, Ww, Wo, Wo, Wo, Wo, Wo, Wwr, Wo, Wo, Wo, Wo, Wo, Wo, Wo, Wo, Wo, Wo, Wo, Wo, Wo, Wo, Wo, Wo, Wo
Wo, Wo, Wwr, Ds, Gg, Ds^Es, Ds, Wwf^Es, Ds, Ww, Ww, Ww, Ww, Ww, Ww, Wo, Wwr, Ww, Ww, Wo, Wo, Wo, Wo, Wo, Wo, Wo, Ww, Wo, Ww, Wo, Wo, Wo
Wo, Wwr, Ds, Ds, Gg, Gs, Gs^Edb, Ds, Gg, Ds, Ds, Wwf, Ds, Ww, Wwr, Wo, Wo, Wwr, Ww, Wo, Ww, Wo, Wo, Wo, Wo, Wwr, Wwr, Wwr, Wwr, Ww, Wo, Wo
Ww, Ww, Ds, Gs^Fdw, Cer^Edb, Cer, Cer, Gs^Fdw, Gg^Ve, Ds, Gs^Es, Ds, Gg, Ds, Wwr, Wwr, Ww, Ww, Ww, Ww, Wwr, Ww, Wwr, Wo, Ww, Ww, Wwf, Ds, Ww, Ww, Ww, Wwr
Wwr, Ww, Ds^Es, Gs^Edb, Cer, 2 Ker, Cer^Edb, Gd^Edb, Hh^Fds, Gg, Gg, Gg, Gs^Fdw, Ds^Es, Wwf, Ww, Ds, Ds^Es, Wwf, Wwr, Wwr, Ww, Wwf, Ww, Ds, Wwr, Ds, Wwf, Ds^Es, Ds, Ww, Wwr
Wwr, Ww, Ww, Ds, Ds, Cer, Hh^Fdw, Gd^Es, Gs^Fdw, Gs^Fds, Gd, Gs^Em, Gg^Efm, Ds^Es, Ds, Ds, Hh^Fms, Ds, Ds, Ww, Ww, Ww, Ds, Ds, Gg, Ds, Gs^Fds, Gs, Gg^Efm, Ds, Wwr, Ww
Wo, Wwr, Ww, Wwf^Es, Ds, Gs^Fdw, Gs^Fms, Mm, Gs^Es, Gg, Gg^Efm, Hh, Gs^Vl, Gg, Gs^Fdw, Gg, Hh^Fdw, Hh^Em, Ds, Ww, Ds, Wwr, Ds^Es, Gg, Ce, Ce, Ce, Gs^Fms, Gg^Ve, Ds, Ds, Ww
Ww, Ww, Ds, Ds, Gs^Fms, Gs, Gg^Efm, Gs^Es, Gd, Gd^Fetd, Gs^Fms, Gs^Fms, Mm^Xm, Hh^Em, Hh^Fdw, Gs, Gg, Ds, Wwr, Wwr, Ds, Ds, Gs^Fds, Gs^Es, Ce, 3 Ket, Ce, Hh^Fds, Gs^Fds, Gg, Ds, Ww
Wo, Ww, Wwf, Ds, Gs^Fms, Hh^Fds, Gs^Vc, Gg, Gg^Efm, Gs^Fdw, Hh^Fmw, Hh^Fms, Mm^Xm, Mm^Xm, Gd^Em, Gs^Em, Ww^Ewl, Ww^Ewl, Ds, Ds, Gg, Mm, Gs^Fds, Gs^Fms, Gs^Fms, Ce, Gs^Fdw, Hh^Fmw, Gs, Ds, Ww, Ww
Wo, Wo, Ww, Ww, Gg, Gs^Fdw, Gg, Gg^Efm, Gg^Efm, Gs^Fms, Hh, Mm, Mm, Mm, Hh^Fdw, Wwr, Ww, Ds, Gs^Fds, Ds, Gg, Hh^Fds, Gg^Efm, Gg^Fet, Gs^Vl, Gg^Efm, Gg^Efm, Gs^Fms, Gg^Efm, Ds, Wwf, Ww
Wo, Wo, Ww, Ds, Ds, Gg^Efm, Gs, Gs, Gs^Fms, Gs, Gs, Gs^Fds, Hh^Fms, Hh, Gg^Efm, Gg, Wwf, Gs^Fms, Gg, Gs^Vc, Gd, Gg^Efm, Gs^Fdw, Gd^Em, Gd^Em, Gg^Efm, Hh^Fdw, Gg, Gg^Fet, Ds, Ds, Ww
Wwr, Wwr, Ds, Wwr, Ds, Ds, Gs^Fds, Gs^Em, Hh^Fds, Gs^Fds, Gg, Gg^Fet, Hh, Hh^Em, Gg, Wwf, Wwf^Es, Gg, Wwf^Em, Gs^Em, Ds, Gs^Fms, Gs^Fds, Gs^Fds, Gs, Mm, Hh^Fms, Gs, Gs^Fms, Gg^Efm, Gs^Fds, Ds
Ww, Wwr, Ww, Ww, Wwf, Gs^Fds, Gg^Ve, Gg, Gs^Es, Gs^Es, Gg, Gg, Gg^Efm, Gg, Gs^Fds, Gs^Fms, Gs^Fdw, Ww^Ewl, Ww, Ds, Ww, Ds, Gs^Fms, Gs^Fds, Gg^Efm, Gs^Fds, Gs^Fds, Gs^Fds, Gg, Gg^Ve, Hh^Em, Gg
Wo, Wo, Ww, Ww, Ds, Gg, Gg^Efm, Gg, Hh, Gd, Gs^Fdw, Gs, Gs, Gg^Ve, Hh^Em, Hh^Fds, Gd, Ds, Ds^Es, Ww, Ds, Ww^Ewl, Ww, Gg, Ww, Ww^Ewf, Wwf, Ds, Ds, Gs^Fms, Hh^Fds, Hh^Fds
Wo, Wo, Ww, Ds, Ds, Gs^Fms, Gs^Fms, Hh^Fds, Mm, Mm, Mm, Gs^Fms, Hh, Gg^Efm, Gg, Gs^Fdw, Gs^Es, Gg, Gs^Fds, Gg, Gll^Fp, Wwf^Em, Sm, Ww, Sm, Ww^Ewl, Ds, Wwr, Ds, Gs^Fds, Gs^Em, Gs
Wo, Ww, Ww, Ds, Wwr, Ds, Gs^Fdw, Mm, Mm, Mm^Xm, Mm^Xm, Mm, Hh^Fms, Gg^Efm, Gs, Gs, Gg, Hh^Fds, Gs^Fms, Gg^Efm, Gs^Em, Wwf, Gll^Fp, Sm^Ewl, Ss, Gll^Fmw, Ds, Wwr, Wwr, Gg, Ww, Wwf
Wo, Wo, Wo, Ww, Wwr, Ds, Gs^Em, Mm, Mm, Mm, Mm, Mm, Hh^Vhh, Gg, Gs, Gg^Fet, Gg^Efm, Gg, Gs^Em, Gg, Gd, Gll^Tf, Gll^Fmw, Ss, Gll^Tf, Ss^Em, Chs, Ww, Ww^Ewl, Ww, Ds, Ww
Wo, Wo, Ww, Wwr, Ds, Ds, Ds, Gs^Fdw, Gs^Fdw, Hh^Fdw, Hh^Fmw, Mm, Mm, Gg, Gg, Gg^Efm, Gg^Efm, Gd, Gg^Ve, Gs^Fds, Mm, Gs^Em, Gs^Em, Gll^Fmw, Gg, Chs^Em, Sm^Ewl, Sm, Ww^Ewl, Ww^Ewf, Gs, Ds
Ww, Ww, Ds, Ww, Wwf, Ww, Ww, Gg, Ww, Hh, Gs^Fdw, Hh^Em, Gs^Fdw, Gg^Efm, Gs^Fms, Gs^Es, Ce, Ce, Ce, Hh^Fds, Gs^Fds, Hh, Gs^Fms, Gg, Ds, Wwf, Ww, Ww, Gll^Tf, Hh, Gs^Fms, Gg
Ww, Wwr, Ds^Es, Ds, Ds, Ds, Wwr, Ww, Wwf, Gg, Ds, Gs^Fms, Gs^Fdw, Gs, Gs^Fms, Hh^Fds, Ce, 1 Ket, Ce, Gs^Fms, Gg^Efm, Hh, Gs^Fds, Ds^Es, Ww, Ww^Ewl, Sm^Em, Ss^Em, Ss, Gll^Fmw, Ss, Gg
Ww, Ds^Es, Gg, Gg, Ss^Vhs, Ss^Em, Sm, Sm^Es, Wwf^Es, Ds, Wwr, Gg, Gs^Em, Gd, Gs^Vc, Hh^Em, Gs^Fds, Ce, Gs, Gg^Efm, Gg^Ve, Gs, Gg^Efm, Ds, Ww^Ewl, Gll^Fp, Gll^Fmw, Ss, Gs^Em, Ww, Wwr, Wwr
Ww, Ds, Hh, Gs^Em, Gll^Fmw, Hh^Fmw, Gll^Tf, Wwf, Ss, Ww, Ww^Ewl, Ww^Ewl, Gg, Gg, Gg, Gg^Efm, Gg, Hh^Fds, Mm, Gg, Gs^Fdw, Gd, Gg, Ww^Ewl, Sm, Ss, Ss^Em, Gg, Gd, Gg, Ds, Ds
Ww, Ds, Ds, Gs^Em, Gd, Gll^Fmw, Ss^Em, Chs, Gll^Fmw, Ds, Ds, Ww^Ewf, Wwf, Ww^Ewl, Ds, Gg^Fet, Gs^Fds, Mm, Mm, Mm, Hh^Fmw, Gs^Fdw, Gg, Ss, Hh^Fmw, Hh^Em, Gg, Gg^Es, Gs^Fms, Gs^Fdw, Gd, Gg
Wo, Ww, Wwr, Ds, Gg, Gg, Ds, Ss^Em, Gll^Fmw, Gg, Hh^Fdw, Hh, Ds, Ww, Ds^Es, Gs^Fdw, Gs^Fdw, Mm, Gg^Efm, Hh^Fds, Gg, Gg, Gg, Gs^Fdw, Gs^Fdw, Hh^Vhh, Hh, Gg^Efm, Gg^Efm, Gs^Fdw, Hh^Em, Mm
Ww, Ww, Ds, Gg^Efm, Gs^Fdw, Hh^Fms, Gg^Efm, Gll^Tf, Gg, Gg, Gg^Efm, Mm, Ds, Ww^Ewl, Wwf, Ds, Wwf^Es, Gg^Efm, Gs, Gg, Hh, Gg^Efm, Mm^Xm, Gg, Gg, Gd^Em, Mm, Gs^Fds, Gs^Fdw, Gg, Gd^Fetd, Gd
Ww, Wwr, Ds, Gs^Em, Gs, Gg^Efm, Gg, Gg, Gg^Ve, Gg^Fet, Gd, Hh, Gg, Ds, Ww, Wwf^Es, Hh, Gg, Hh, Gs^Fdw, Hh^Fds, Mm^Xm, Mm, Mm, Ww^Ewl, Gs, Gs^Em, Hh^Fdw, Gs^Fdw, Gg^Efm, Gg, Gs^Fdw
Ww, Wwf, Gg, Gg, Gg^Es, Gg, Gg, Gs^Fdw, Ss, Gll^Fmw, Gs^Em, Gg^Efm, Ds^Es, Ds, Wwr, Wwr, Gd, Gs^Em, Hh, Hh^Fds, Mm, Mm, Hh^Vhh, Hh^Fds, Gg^Fet, Ww^Ewl, Hh, Gs^Fds, Hh, Gg, Ds, Ds
Ww, Ds, Ds, Gs^Fdw, Gs^Fms, Gg^Efm, Gs, Ss, Ww, Sm, Wwr, Ds, Ww, Ww, Ds, Gs^Fms, Ds, Gs, Gg, Gg^Efm, Gs, Gs^Em, Gg^Efm, Hh, Ds, Ww, Ds, Gs^Es, Gs^Vc, Gg, Ds, Wwr
Wo, Wwr, Ds, Gs^Fds, Mm, Hh^Fdw, Ds, Ww, Ds, Wwf, Wwf, Ww, Ds, Ww, Ww, Ds, Wwr, Ds, Ww, Wwr, Ds, Ds, Ds^Es, Gg, Ds, Wwr, Wwf, Ds, Ds, Ds^Es, Ds, Ww
Wo, Wwr, Ww, Ds^Es, Ds, Ds^Es, Ww, Wwf, Ds, Gs^Fdw, Gg, Gs^Fds, Hh^Fds, Wwf, Wwf^Es, Ww, Ww, Wwr, Ww, Wwr, Wwr, Wwf, Ww, Ds^Es, Ww, Ds, Wwr, Wwr, Ww, Wwf, Ww, Ww
Wo, Wo, Ww, Ww, Ww, Ww, Ww, Ww, Ds, Ds, Gg^Efm, Gs, Ds, Ds, Ds, Wwr, Ww, Wo, Ww, Ds, Ww, Ww, Ww, Ww, Ww, Ww, Ww, Ww, Wo, Wo, Wo, Wo
