Wo, Wo, Wo, Wo, Wo, Wo, Wo, Ww, Ds, Wo, Wo, Wo, Wo, Wo, Wo, Wo, Wo, Wo, Wo, Wo, Wo, Wo, Wo, Wo, Wo, Wo, Wo, Wo, Wo, Wo, Wo, Wo
Wo, Wo, Wo, Wo, Wo, Wo, Ww, Ww, Ww, Wwr, Wo, Wo, Wo, Wo, Wo, Wwr, Ww, Wo, Ww, Wo, Wo, Wo, Ww, Wo, Ww, Wo, Wo, Wo, Wo, Wo, Wo, Wo
Wo, Wo, Wo, Wo, Wwr, Ww, Ds, Ww, Ds, Ww, Wwr, Wo, Ww, Wo, Ww, Ww, Ww, Ww, Ww, Ww, Ww, Ww, Wwf, Ds, Ww, Ww, Wwr, Wo, Wo, Wo, Wo, Wo
Wo, Wo, Wo, Wo, Ww, Ds^Ftd, Gs^Ft, Ww^Wkf, Wwf, Ww, Ww, Ww, Wwr, Wwr, Wwf^Em, Ds, Wwr, Ww^Vm, Ww^Wkf, Wwr, Gs, Ds, Ds, Wwr, Wwr, Ww^Wkf, Ds, Wwr, Wo, Wo, Wo, Wo
Wo, Wo, Wo, Wo, Ww, Ds^Ftd, Ww^Wkf, Wwr, Gs^Ftp, Hh^Ft, Ww, Ww, Wo, Wwr, Ww^Wkf, Wwf, Ww, Ww, Wwf, Wwr, Hh^Ftp, Hh^Ft, Gd^Fetd, Gs^Ftp, Ds, Ww^Wkf, Ww, Ww, Wo, Wo, Wo, Wo
Wo, Wo, Wo, Ww, Wwf, Ww^Wkf, Ww^Wkf, Ds^Em, Ds^Vda, Gs^Ft, Ww, Wo, Wo, Ww, Wwf^Dr, Ww^Wkf, Wo, Ww, Ds, Ds^Ftd, Mm, Ce, 1 Ket, Gg^Efm, Gs^Ft, Wwf^Es, Ww, Wo, Ww, Wo, Wo, Wo
Wo, Wo, Wo, Ww, Wwr, Wwr, Ww, Wwf, Wwf^Dr, Ww, Ww, Ww, Ww^Wkf, Wwr, Ds^Vda, Gs, Wwr, Ww^Wkf, Wwr, Gs^Em, Gs^Ft, Ce, Ce, Gll^Fdw, Gs^Vht, Ds, Wwr, Ww, Wwr, Wo, Wo, Wo
Wo, Wo, Wo, Wo, Wwr, Ds, Ww, Wwr, Wo, Ww, Ds, Ww, Ww, Ds, Gs^Ft, Gll^Fdw, Ds^Es, Ww^Wkf, Wo, Hh, Ds, Isa, Ds, Gd^Tf, Hh^Ft, Gs, Ds, Ww, Wwr, Wo, Wo, Wo
Wo, Wo, Wo, Wo, Ds, Ww, Ww^Edb, Wo, Ww, Wwr, Wwr, Wwr, Wwr, Ww, Wwr, Ds^Ftd, Ww, Ww, Ww, Ww, Ww, Wwf, Wwr, Ds^Em, Hh^Ftr, Gs^Ftp, Ww^Wkf, Ww, Wo, Wo, Wo, Wo
Wo, Wo, Wwr, Ww, Wwr, Wwr, Wwf^Edb, Ww, Ww^Wkf, Ww^Edb, Ww^Edb, Wo, Wo, Ww, Ww, Ww^Bw|r, Gg, Wwr, Wwr, Ww, Wo, Ww, Ww^Wkf, Ww^Wkf, Ww, Wwr, Ww, Ww^Vm, Wo, Wo, Wo, Wo
Wo, Wo, Ww, Ww, Ds, Ds, Cme^Edb, Cme, Cme, Wwr, Ww, Wo, Wo, Ww, Ww^Wkf, Hh^Em, Hh^Ft, Wwf, Ds, Ww, Wo, Wo, Ww, Ww^Wkf, Ww, Ww, Ww, Ww, Wwr, Wwr, Wo, Wo
Wo, Wo, Wo, Ww^Wkf, Ds^Es, Isa, Hh^Em, 2 Kme^Em, Gll^Fdw, Ds, Ww, Wwr, Ww^Vm, Wo, Ww^Wkf, Ds, Ds^Es, Dd^Do, Ds^Ftd, Ww, Ww, Ww, Wwr, Ww, Ds^Vda, Dd^Ftd, Wwr, Ww, Ww, Wwr, Wo, Wo
Wo, Wo, Wo, Ww^Wkf, Wwf, Ds^Ftd, Hh^Ftr, Gd^Tf, Gs^Vht, Gg^Efm, Wwf^Es, Ww, Wo, Wo, Wo, Ww, Wwr, Gs^Ftp, Wwr, Ww, Wo, Ww, Ds^Es, Wwf, Ds, Gs^Ft, Ww, Wwf, Ww^Wkf, Wo, Wo, Wo
Wo, Wo, Ww, Wwr, Wwr, Ds^Ftd, Gs^Ftp, Gd^Fetd, Ds, Gs^Ftp, Ww^Edb, Ww, Ww, Ww, Ww^Ii, Wo, Ww^Wkf, Wwf^Dr, Wwr, Wwr, Ww, Ww, Ww, Ds^Es, Wwf, Chw, Ww^Wkf, Ds, Ds, Ww, Wo, Wo
Wo, Wo, Ds, Ds^Ftd, Ww, Ww^Wkf, Ww^Wkf, Ds, Wwr, Wwf, Wo, Ww, Ds^Vdt, Ds^Es, Ds, Wwr, Ww, Ww^Wkf, Ww, Ww, Ds, Ww^Wkf, Wwf^Es, Ww^Bw|r, Ww^Edb, Ww^Wkf, Ww^Wkf, Ds^Es, Ww, Ww, Wo, Wo
Wo, Ww, Wwf, Gs^Ftp, Ww, Ww^Edb, Ww, Wwr, Chw, Wwr, Wo, Ww, Ww, Gs^Ftp, Ww, Ww, Ww^Wkf, Wo, Ds, Gs^Ftp, Gg^Efm, Ds^Es, Gs^Vht, Wwf, Ds, Ww^Edb, Ww, Ww, Wo, Wo, Wo, Wo
Wo, Wwr, Wwr, Ds, Wwr, Ds, Ww, Ww, Ww^Wkf, Ww, Ww^Wkf, Wo, Ww, Ww, Ww, Wwr, Ww^Wkf, Ww^Wkf, Wwf^Edb, Hh^Ft, Hh^Ftr, Hh^Ft, Gll^Fdw, Wwf^Dr, Hh, Wwr, Ww, Wwr, Wo, Wo, Wo, Wo
Wo, Wo, Wo, Ww, Ww, Wwr, Ww, Ww^Wkf, Ds, Ds^Vda, Ds^Es, Wwr, Ww, Ds, Wwr, Wo, Wo, Ww, Wwr, Cme^Edb, 3 Kme, Mm, Dd^Do, Gs^Em, Ds, Wwr, Wo, Wo, Wo, Wo, Wo, Wo
Wo, Wo, Wo, Wwr, Wo, Ww, Wo, Ww, Wwf, Hh^Ftp, Gg^Efm, Gs^Em, Wwr, Ww, Wo, Wo, Ww, Wwr, Wwr, Cme, Cme^Edb, Isa, Ds^Es, Wwr, Ww, Ww, Wo, Wo, Wo, Wo, Wo, Wo
Wo, Wo, Wo, Wo, Wo, Wo, Wo, Ww, Ww^Wkf, Ds, Wwr, Wwf, Ww, Wo, Wo, Ww^Vm, Ww, Ww^Edb, Ww, Ww^Edb, Wwf^Edb, Ds, Ww^Wkf, Ww, Wo, Wo, Wo, Wo, Wo, Wo, Wo, Wo
Wo, Wo, Wo, Wo, Wo, Wo, Wo, Wo, Wo, Wo, Wo, Ww, Wo, Wo, Wo, Wo, Wo, Wo, Wo, Ww^Edb, Wo, Wwr, Ww, Ww, Wo, Wo, Wo, Wo, Wo, Wo, Wo, Wo
Wo, Wo, Wo, Wo, Wo, Wo, Wo, Wo, Wo, Wo, Wo, Wo, Wo, Wo, Wo, Wo, Wo, Wo, Wo, Wo, Wo, Wo, Wo, Wwr, Wo, Wo, Wo, Wo, Wo, Wo, Wo, Wo
