Mm, Mm, Mm, Gg, Wwf, Hh, Ss, Gg, Wwf, Gg, Hh^Em, Hh^Fds, Mm, Mm, Mm, Gg, Hh, Hh, Hh, Mm, Mm^Xm, Mm, Mm, Mm^Xm, Mm^Xm, Mm, Ds^Es, Mm, Hh^Fms, Gs^Fms, Gg, Hh^Fmw, Hh^Em, Mm, Mm^Xm, Mm^Xm
Gs^Fds, Hh, Gg, Gd^Fetd, Chr, Wwf^Em, Ss^Emf, Ds, Gs, Gg^Efm, Gll^Tf, Hh^Em, Mm, Mm, Gs, Hh^Em, Gg, Hh^Fds, Hh^Fds, Mm, Mm, Mm, Hh^Tf, Mm, Mm, Mm^Xm, Mm, Ds, Wwf, Gs^Em, Ds, Hh^Tf, Hh^Fmw, Hh, Hh^Fmw, Mm^Xm
Gg, Gs^Fds, Chr^Dr, Gd^Edb, Chr^Edb, Chr, Ss, Ss^Vhs, Sm^Edb, Ss^Edb, Gg, Mm^Xm, Hh, Gg^Em, Ss^Emf, Ds, Wwf, Gs^Fds, Gs, Hh, Gg^Ve, Hh^Em, Hh, Hh^Em, Gg^Ii, Mm, Hh^Fms, Hh^Em, Hh, Gg^Efm, Mm, Mm, Mm^Xm, Mm, Mm, Mm
Mm, Gd, Gs, Ss^Edb, Chr^Edb, 2 Khr^Edb, Chr, Chr, Sm^Edb, Ss, Wwf, Gll^Fmw, Gd^Em, Gll^Tf, Ss^Vhs, Ds, Ds, Gs^Edb, Gg^Efm, Gs^Fms, Ds, Gs, Gs^Fds, Gs^Fms, Gd, Gg^Efm, Ds, Hh, Gs, Gs^Fds, Hh^Fms, Mm, Mm, Mm, Mm, Hh^Fms
Hh, Hh^Vhhr, Mm, Ss, Ss, Chr, Mm, Chr, Gs, Chr^Dr, Gg^Edb, Gs^Edb, Wwf, Ww^Wkf, Ww^Wkf, Ww^Wkf, Gll^Fmw, Ss, Ds^Es, Chr^Dr, Ds, Ww^Wkf, Ww^Wkf, Ds^Es, Ds, Wwr, Wwf, Ds, Gd, Gs^Fms, Mm, Mm, Ds^Es, Mm, Hh, Gs^Fms
Mm, Mm, Mm^Xm, Mm, Mm^Xm, Gs, Gd^Em, Mm, Ww^Wkf, Gg, Wwf, Ss, Chr, Chr, Chr, Sm, Ss^Emf, Ds, Wwf^Edb, Ds^Es, Ss, Ww^Wkf, Wwf, Wwr, Ww, Wwf, Ss, Wwf, Gs^Fms, Gd^Fetd, Gs^Fmw, Ds, Ww, Hh, Gd, Gs
Mm^Xm, Mm, Mm, Mm^Xm, Mm, Mm, Gg^Edb, Gs^Fds, Wo, Ww^Wkf, Wwf, Sm^Ewf, Chr^Edb, 3 Khr, Chr^Edb, Ss, Ww^Wkf, Wwf, Wwf, Ss, Ww^Wkf, Sm, Ss, Ds, Ss^Emf, Gll^Fmw, Ss, Ds, Ds, Wwf, Ss^Emf, Ww, Wwf^Em, Ss, Ds, Ds
Mm, Mm^Xm, Mm, Mm, Mm, Mm, Gs^Em, Gll^Fmw, Hh, Ds, Gs, Ww, Sm, Chr^Edb, Gg, Wwf^Edb, Gd^Vhr, Gg, Gll^Fdw, Sm, Ww^Wkf, Sm, Gs^Vl, Hh, Wwf, Gll^Tf, Ww, Wwf^Em, Gll^Fmw, Ss, Chs^Em, Ss^Em, Gll^Fmw, Gs, Wwf^Em, Gll^Fmw
Hh, Mm, Hh, Hh, Gg, Ww^Wkf, Gg^Efm, Gg^Ve, Gs^Fms, Gd, Gs^Fms, Wwr, Ww^Edb, Wwf, Hh, Gs^Fms, Mm^Xm, Gll^Fmw, Mm, Wwf, Ss, Ww^Wkf, Ds^Es, Ds, Ds, Ww^Wkf, Ww, Sm^Ewl, Sm^Em, Hh, Chs, Chs, Hh^Fmw, Hh, Ww, Ww
Ss, Hh^Em, Gg, Chr^Dr, Gll^Fmw, Wwf, Mm, Mm, Mm, Hh, Gd^Fetd, Gg^Edb, Ww, Wwf, Mm, Mm^Xm, Mm, Hh, Mm^Xm, Mm, Hh^Fmw, Wwf, Ww, Wwf, Ww^Wkf, Wwf, Sm, Sm^Ewl, Ss^Vhs, Ss^Emf, Chs, 4 Khs, Chs, Chs, Ss, Gg
Wwf, Wwf, Sm^Em, Ss, Wo, Wo, Hh^Fmw, Mm, Mm, Mm, Ds, Ds, Wwr, Wwf^Es, Gg^Efm, Mm, Mm, Mm, Mm, Mm, Hh, Gll^Fdw, Wo, Ww^Wkf, Wwf^Em, Ss, Ss, Gll^Tf, Gll^Fmw, Ss, Ww^Ewf, Ss, Chs^Em, Chs, Ss, Wwf
Gll^Fmw, Ss, Ss^Em, Sm^Ewf, Sm^Ewl, Gg^Efm, Gs, Gll^Fdw, Hh, Chr^Dr, Ww^Wkf, Ww, Wo, Ss^Vhs, Gs, Gd^Fetd, Hh, Hh^Fmw, Gll^Fmw, Mm, Ds, Ss, Ww^Wkf, Ww^Wkf, Sm^Ewl, Ww, Ww^Wkf, Wwf, Sm, Sm^Ewl, Wwf, Ss, Sm^Em, Ss^Emf, Ss^Vhs, Wwf
Gg, Gll^Fmw, Gg^Ve, Sm^Ewl, Ww^Wkf, Ss, Gll^Fmw, Ds, Ww, Ww, Wo, Wo, Wo, Wwr, Wwf^Em, Gs^Fds, Gd, Hh, Gll^Fdw, Ss, Ss^Emf, Ss, Sm, Wo, Gll^Fmw, Ds, Gll^Fdw, Ww, Ss, Wwf^Em, Ds, Gll^Fdw, Sm^Ewl, Sm^Ewf, Gll^Fmw, Gg
Hh, Mm, Gll^Fmw, Ww^Wkf, Gs^Fms, Gg^Efm, Wwf, Ds^Es, Ww, Wwf^Edb, Wwr, Ww, Wwf^Edb, Wwf^Es, Ww^Wkf, Gll^Fmw, Mm, Mm, Ds, Ds, Ww^Wkf, Ss, Gll^Fmw, Sm, Ss, Ss, Ss, Ss, Ss, Hh^Fmw, Hh, Gd, Hh^Tf, Hh, Hh, Gg
Ds, Ww^Wkf, Gs^Fms, Gd^Em, Ds, Ds, Ww, Ww^Wkf, Wwr, Wo, Wwf, Ww, Ww^Wkf, Wwf, Wo, Ds, Ds^Es, Wwf, Ww^Wkf, Ww, Ss, Ss, Hh^Fmw, Hh^Vhhr, Ww^Wkf, Sm, Sm^Ewf, Sm, Ww^Wkf, Mm, Hh, Mm, Mm, Mm^Xm, Gs, Gs^Fds
Wwf, Ds, Gs^Fds, Gs^Efm, Ds, Ww, Wwr, Ds^Es, Ds, Gd, Gs^Fms, Wwf, Hh, Ww^Wkf, Wwf, Ww, Ww, Wwr, Ww^Wkf, Sm, Wwr, Sm, Sm^Ewl, Sm^Em, Sm^Em, Wwf, Ww^Wkf, Ss, Gd, Gg^Efm, Mm, Mm, Mm, Mm^Xm, Mm, Hh^Fds
Wwf, Ds, Ds, Gg, Ww, Ww, Ss, Ds, Ss, Gg, Mm, Mm, Mm, Hh^Em, Ds, Wwf, Wwr, Wo, Wo, Wo, Ww, Ss, Ww^Wkf, Sm, Wo, Ww^Ewl, Ww^Wkf, Ds^Es, Gs^Fds, Gs^Fms, Mm, Mm, Hh^Fmw, Hh, Mm, Hh
Ww, Wwr, Ds^Es, Chr^Dr, Wwr, Ds, Gg, Ss^Vhs, Gll^Fmw, Mm, Mm, Mm^Xm, Mm, Gg, Ss, Ss, Sm^Em, Ww, Ds^Edb, Ww^Wkf, Ds, Ss, Wwf, Wwf, Ds^Es, Wwr, Ww, Ds, Ss^Vhs, Gg, Gs^Fmw, Gs^Fds, Gd, Mm, Gs^Fms, Hh^Fmw
Ww, Wwr, Ww, Ww, Wo, Ds, Ds^Es, Ww^Wkf, Hh, Hh^Em, Mm, Mm, Hh, Gs^Em, Ss, Ss^Emf, Gll^Tf, Ss^Vhs, Gg, Ds, Hh^Fms, Ww, Hh, Ds, Wwf, Wwf, Ww, Wwf, Ds, Gd^Em, Gll^Fdw, Gd^Fetd, Gll^Fdw, Gg, Hh, Gg
Wo, Wo, Ww, Ww, Wwr, Wwf^Es, Wwf, Ds, Gg, Gg, Ss, Hh^Fmw, Sm^Ewl, Gll^Fmw, Gll^Fdw, Sm^Ewl, Ww, Wwr, Gs^Fms, Gg, Hh, Mm, Ds, Ds, Ds, Ds, Wwf^Es, Ww, Ds, Gg, Ds, Gg, Mm, Gs^Fmw, Mm, Mm
Wo, Wo, Wwr, Ww, Ww, Ds, Ww, Ds, Ds, Ss, Gs^Fms, Gg, Wwf, Sm, Ss, Ss^Vhs, Sm^Ewf, Sm^Ewl, Hh^Fms, Mm, Mm, Mm, Ds, Wwf, Wwr, Ds, Wwr, Ww, Wwf, Ds, Wwf, Ds^Es, Gs^Fds, Hh, Mm, Hh
Wo, Wo, Wo, Wo, Ww, Ww, Wwr, Ww, Ds, Gd, Ss, Ss^Em, Ce, Ce, Ce, Ss, Wwf, Sm^Em, Gs^Fds, Mm, Gg^Efm, Gg, Ds, Ds, Ww, Wo, Ww, Ww, Ds, Wwr, Ds^Es, Ds, Wwf, Gll^Fdw, Gs^Em, Gg
Wo, Wo, Wo, Wwr, Ww, Ds, Wwr, Wwf, Ds, Gg, Ds, Gll^Tf, Ce, 1 Ket, Ce, Gs^Fms, Ds, Ss, Gg, Gs^Fmw, Ds, Gs^Fms, Ds, Wwr, Ds, Ww, Ww, Wwr, Ww, Ww, Ww, Ds, Ds, Ds, Ds^Es, Ds
Ww, Ww, Ww, Ww, Ww, Wwr, Ww, Ds, Ww, Ds^Es, Ds, Wwf^Em, Wwf, Ce, Sm^Ewl, Gd, Ds, Ds, Ds, Ds, Wwf, Ds, Wwr, Ww, Ww, Ww, Wo, Ds, Wwr, Ww, Ww, Ww, Ww, Wwr, Wwr, Wwr
Wo, Ww, Wwr, Wo, Wo, Ww, Ww, Ww, Ww, Wwr, Wwr, Ds, Ww^Wkf, Ss, Wwf^Em, Gll^Fdw, Ds^Es, Wwf^Es, Ww, Wwr, Wwr, Wwr, Ww, Ww, Wo, Ww, Wwr, Wo, Wo, Wo, Wwr, Wwr, Wo, Ww, Wo, Ww
Wo, Wo, Wo, Wo, Ww, Ww, Wo, Wo, Wo, Wo, Wwr, Ds, Ds, Ds, Ds, Ds, Ww, Ww, Wo, Ww, Ww, Ww, Wo, Wo, Wo, Wwr, Wo, Wo, Wo, Wo, Wo, Wo, Wo, Wo, Wo, Wo
