Ww, Ww, Ds^Es, Ds, Ds, Ds, Gs^Fds, Hh^Fds, Gs, Mm, Hh, Ds, Ds, Ww, Ww, Wo, Wo, Wo, Wo, Wo, Wwrg, Ww, Wo, Wo, Wo, Wo, Wo, Wo, Wo, Wo
Ds, Ds^Ewsh, Gg, Gs^Fdw, Gg^Efm, Gs^Fms, Gg^Ve, Gd^Em, Gg, Gs^Fds, Gs^Fms, Mm, Ds, Wwrg, Ds, Ww, Ww, Ww, Ww, Ww, Wwf, Wwrg, Ww, Wo, Ww, Ww, Ww, Wo, Wwrg, Wo
Gs^Fds, Gs^Fds, Cvr, Cvr, Cvr, Gs^Es, Gs^Fds, Hh^Fds, Mm, Gg^Fet, Gg, Gs^Em, Ds, Ds^Es, Gg, Ds, Wwf, Ww^Wkf, Ds, Ds, Ds^Es, Ds^Ewsh, Ds, Ww, Ww, Ww, Wwf, Ww, Ww, Wo
Mm, Hh^Fmw, Cvr, 3 Kvr, Cvr, Gs^Fms, Gs^Fmw, Hh^Fms, Gs, Gg^Efm, Gs^Fms, Gd, Gs^Fds, Gs, Gs^Fmw, Ds, Ds^Es, Wwf^Es, Ds, Hh, Hh^Fms, Gg, Gs, Ds^Bw/, Ds, Ds^Es, Ds, Ds, Ww^Wkf, Wwrg
Gs, Gd, Gg, Cvr, Gg^Fms, Gs^Fds, Gd, Gg^Ve, Gs^Fms, Hh^Fds, Mm, Gs^Fds, Gg, Gs^Vh, Gg^Efm, Ds, Gs^Fms, Ds, Mm, Hh, Gs, Gg^Efm, Gg, Gs, Gg, Hh, Gg^Efm, Ds^Ewsh, Ds, Wwf
Hh^Fds, Gg^Efm, Gg^Fet, Gg^Efm, Gg, Gs^Es, Gg, Gg^Efm, Gs^Fms, Gs^Fmw, Gs, Gs^Fms, Gs^Fds, Gs, Gs, Gs^Fds, Gg, Hh, Mm, Mm^Xm, Gd^Em, Gg, Gs^Fdw, Gs^Fdw, Gs^Fds, Gs^Fdw, Mm, Gs^Fdw, Hh, Ds
Gs^Fds, Hh^Fms, Gs^Fds, Gs^Fdw, Gg, Gg, Gs^Fdw, Gg, Gg, Gg^Efm, Gs^Efm, Hh^Fds, Mm, Gs^Fms, Mm, Gg, Gs^Fetd, Gs, Gs^Vc, Hh^Fms, Gg, Gg, Gg^Efm, Gs^Fds, Mm, Hh^Fms, Mm, Mm, Mm, Hh
Gd, Mm, Hh^Fmw, Gs^Vc, Gg, Gs^Fds, Gs^Fms, Gs^Fdw, Gs^Fmw, Gg, Gg, Hh, Hh^Es, Hh, Hh, Hh, Mm, Gd^Emf, Ss, Gll^Fdw, Gg^Edb, Gs, Gs^Fdw, Gg, Gs, Hh, Hh^Vhhr, Mm, Mm, Hh
Gs^Fds, Gs^Es, Gg^Efm, Gg, Gs^Fdw, Hh^Em, Hh^Fds, Hh^Fds, Hh^Fds, Gg^Fet, Gg^Fds, Gs, Mm, Mm, Mm, Mm, Mm^Xm, Hh^Em, Ss, Gg, Gs^Edb, Gs^Em, Hh^Fms, Hh, Mm, Gs^Edb, Gg^Edb, Gg, Gs, Gs
Hh, Gs^Fms, Gs^Fds, Gs^Fds, Mm, Mm, Mm^Xm, Mm, Hh^Es, Gg^Fds, Gg, Hh, Mm^Xm, Mm, Mm, Mm, Mm, Ww^Wkf, Gd^Tf, Gll^Fdw, Gg, Gll^Fdw, Mm, Mm, Hh, Gg, Gs^Emf, Gs^Ecf, Gg, Hh^Fdw
Hh^Fds, Gg^Efm, Gg, Mm, Mm, Mm^Xm, Mm^Xm, Mm, Hh, Gs^Fdw, Gg^Ii, Mm, Mm, Mm, Mm, Mm, Mm, Hh, Gg, Ss^Vhs, Gg, Ss, Ss, Ww^Ewl, Gg^Edb, Gs^Em, Chr^Edb, Gd^Em, Hh, Gs^Fdw
Gs^Fdw, Gg, Gs^Fdw, Hh^Fds, Mm, Mm, Mm, Mm, Gg^Fds, Gs, Gg^Ve, Gg^Fds, Mm, Mm^Xm, Mm, Hh, Hh^Em, Hh, Ss, Gs, Gg^Wm, Gll^Fmw, Gg^Edb, Gg, Gd^Em, Chr^Edb, 2 Khr, Chr, Mm, Gs^Fds
Gg, Gd, Gs^Es, Gs^Es, Gs^Fds, Mm, Hh^Fms, Gs^Es, Gg^Efm, Gg^Efm, Gs, Gd^Em, Hh^Fms, Mm, Hh, Mm, Gg^Edb, Gd^Em, Gg, Gg, Gg, Gg^Edb, Gs^Emf, Gs^Vc, Gg^Em, Chr, Chr^Edb, Chr, Gg, Gs^Edb
Hh^Fds, Gs^Fds, Hh^Fds, Gg, Gg^Efm, Hh^Em, Gs^Fms, Gd, Gg, Mm, Gs^Fds, Gs, Gs^Fdw, Gs^Fms, Hh^Fds, Gs, Gs^Edb, Gs, Gg^Wm, Gg^Es, Gg^Efm, Gs, Ss, Gs^Es, Gs^Fdw, Gs^Edb, Gs^Es, Gll^Fdw, Hh^Fdw, Gg^Efm
Mm, Mm, Mm, Mm, Gs^Fdw, Gs, Gs^Fds, Gs^Fds, Gg^Fet, Gs^Fms, Ds, Ss, Gs, Gg^Fet, Chr^Dr, Gs^Fds, Gg, Gg, Gg, Gs, Hh, Ss, Mm, Gs^Fms, Hh, Gd, Mm, Ss, Mm, Mm
Hh, Mm, Hh^Em, Hh, Gg, Gs^Em, Gs^Fmw, Mm, Hh, Hh, Gs^Fds, Gg, Gs^Fdw, Hh, Gg, Gg, Gg^Edb, Gs^Em, Hh^Em, Mm, Wwf^Em, Hh^Em, Ww^Wkf, Mm, Ww^Ewl, Hh, Ds^Es, Mm, Mm, Mm
Hh, Mm^Xm, Mm, Hh^Vhh, Gs^Fmw, Gg, Ds, Gs^Es, Gs^Efm, Hh^Fds, Gs^Wm, Gg, Gd, Gs^Em, Gg, Gs, Gd^Edb, Gs^Vh, Gs^Fds, Hh, Ww^Wkf, Ww, Wwr, Ww, Wo, Wwf, Ww, Ww^Ewl, Ww^Ewf, Ww
Gs^Fms, Hh^Fms, Gs, Gs^Fds, Hh, Gg, Gs^Fms, Hh, Gg, Gg^Efm, Gg, Gg, Hh^Fms, Gs^Fms, Mm, Hh, Gs^Fdw, Gs^Fms, Hh^Fds, Wo, Ww, Ww^Wkf, Wo, Wwr, Wo, Wwr, Hh, Mm, Ww^Wkf, Ww^Wkf
Gs^Fds, Gg, Gs^Fdw, Gd, Gs^Emf, Gs^Em, Gg, Mm, Gg, Gg, Gg, Gs, Gg, Gg, Gg^Efm, Gs, Mm, Gg^Fet, Mm^Xm, Wwr, Ww, Wo, Ww^Wkf, Ww, Wwr, Ww^Ii, Mm, Mm^Xm, Wo, Wo
Gs^Fds, Gg, Gg^Ve, Gs^Fmw, Gg, Gg, Gs, Gs, Gll^Fdw, Gs^Fdw, Ds, Gs^Es, Gs^Fetd, Gd^Es, Ss^Vhs, Gll^Fmw, Wwf, Gs^Fms, Hh^Em, Mm^Xm, Ds, Ww^Ewf, Wwr, Wo, Wwr, Re, Hh^Em, Wwr, Wo, Wo
Gg, Gg, Gg^Efm, Gs^Es, Gg, Gg^Es, Gd^Em, Gs^Fms, Ss, Ww^Wkf, Gd, Gs^Vl, Gd, Gll^Fdw, Hh, Ss, Gd^Tf, Ss, Gg^Es, Gs^Fds, Gs^Fms, Ww, Ww, Ww^Ewf, Ww, Ww, Ww^Wkf, Wo, Wo, Ww^Wkf
Gs^Fds, Gs^Fms, Gs^Fdw, Gg, Gs^Fms, Gg, Gg^Efm, Gll^Fdw, Hh^Fms, Ss, Gg^Es, Gg, Gs^Fms, Gs, Gg, Gg, Gg^Efm, Gg, Gg, Gg^Efm, Gs, Wwf^Es, Hh^Fds, Ww, Ds, Wo^Bw|r, Ww^Ewl, Wwr, Ww, Ww
Gs, Hh^Fds, Chr, Chr, Chr, Hh, Gg, Gs^Fds, Mm, Hh, Gd, Gs^Es, Ww^Ewl, Gll^Fdw, Gd, Gs^Fms, Mm, Mm^Xm, Mm, Hh^Fds, Ds, Gs, Gg, Gs^Vc, Gs, Gg, Mm, Ww, Mm^Xm, Mm^Xm
Gg, Gs^Fdw, Chr, 1 Khr, Chr, Gs^Fms, Gg, Hh^Vhh, Wwf, Hh^Fmw, Gll^Fmw, Gll^Fdw, Ss, Ss, Wwf, Gs^Fds, Wwf, Mm, Ww, Wwf, Ww^Ewf, Hh, Ww^Wkf, Gg^Efm, Ds, Wwf^Em, Wwf, Hh, Mm, Mm
Mm, Gs, Gs^Fds, Chr, Hh, Gd^Em, Gg, Gll^Fmw, Ss, Sm, Ss, Ww^Wkf, Sm, Sm^Ewl, Hh^Em, Mm^Xm, Ww, Ww^Ewl, Wo, Ww^Wkf, Wwr, Ww, Ww, Wwr, Hh, Ww, Ww, Ww^Wkf, Wwr, Wo
Mm, Hh, Gg, Gs^Fms, Gg, Gs^Fms, Gll^Fmw, Gd^Tf, Ww^Ewl, Ww^Ewl, Ss, Ss^Emf, Sm, Gs^Fms, Hh^Fds, Mm, Ww, Wo, Wo, Wo, Wwr, Wo, Wo, Ww^Ewl, Hh, Wo, Wo, Ww^Ewf, Ww, Ww^Ewl
