Wo, Wo, Wwr, Wwr, Ds, Ds, Mm, Mm, Mm, Mm, Mm, Gs, Gs^Fdw, Ds, Ww^Wkf, Ww, Wwr, Ds, Ds, Gs, Gd^Fdf, Ww, Ww^Ewl, Ds, Ds^Ewsh, Hh, Mm, Hh^Fdf, Mm, Mm, Mm, Ds, Ds, Wwf, Wwf^Es, Ww
Ww, Ww, Ds^Ewsh, Ds, Gs^Fmw, Hh^Fds, Gg, Hh^Fdf, Hh^Fdf, Mm, Mm^Xm, Hh^Fdf, Hh, Ds, Wwr, Ww^Ewl, Ww^Wkf, Wwr, Gs^Efm, Gd^Fdw, Mm, Gg^Efm, Hh^Em, Wwf, Ww^Ewl, Ds, Gs, Gg^Ve, Hh^Fdf, Mm, Gd^Fdf, Gs^Fdw, Gg^Efm, Ds, Ww^Ewl, Wwr
Wwr, Ds, Gg^Ve, Hh^Fdf, Gs^Fdf, Gs^Emf, Ce^Em, Ce, Ce, Gg, Mm, Mm^Xm, Hh^Fdw, Wwf^Es, Ww, Wo, Wwf, Ds, Mm, Mm^Xm, Mm, Mm^Xm, Gd^Fmf, Ds, Ww^Ewf, Ww^Wkf, Ds^Es, Gd^Em, Ds, Gs^Es, Ds, Ds, Ds, Gs^Fdw, Ds, Ww^Ewl
Ds, Ds, Gg^Efm, Gs^Fdw, Gs, Gd^Em, Ce, 1 Ket, Ce, Gg^Efm, Gd^Emf, Hh^Fds, Gd^Fdf, Ds, Wo, Wo, Wwr, Ds^Em, Mm, Mm, Hh^Fds, Hh^Fdf, Ds, Gs, Ds^Ewsh, Ww^Wkf, Ww, Ds, Ww^Ewl, Wwr, Ww^Wkf, Ww, Wwf^Ewsh, Ds, Ww^Wkf, Ww
Gd^Fdw, Gs^Fdf, Ds, Gd, Ds, Gs^Fdw, Gs^Efm, Ce, Gs^Fdw, Gs, Gs^Fdw, Gs^Em, Ds, Ww^Ewl, Ww, Ww^Wkf, Gg, Gs^Fdw, Hh^Fdf, Mm, Mm, Hh^Em, Wwr, Ds, Wwf, Wwf^Dr, Wwr, Ww, Wwr, Ds, Hh, Hh, Mm^Xm, Wwr, Ds, Ww
Ds, Ds^Ewsh, Wwr^Dr, Wwf, Ds, Gs^Vl, Gd^Fdw, Gd^Em, Gs^Fmw, Hh^Vhh, Hh^Fds, Gs^Fmw, Gg, Wwf, Ww, Ds, Ds, Ds, Ds^Es, Ds, Ds, Wwf^Em, Ww, Wo, Ww^Wkf, Ww, Wo, Wo, Wwr, Ds^Es, Mm^Xm, Mm, Mm, Mm, Hh, Ds^Es
Ww, Wwr, Ww^Ewf, Wwr, Ww^Wkf, Ds, Gg, Gs, Gs, Hh, Gs, Gd^Em, Ds^Ewsh, Ds, Wwr, Ww, Wwr, Wwr^Dr, Wwf, Wwr, Ww^Wkf, Ww^Ewl, Ds, Ww^Wkf, Ds, Ww^Ewl, Ww^Ewf, Wo, Ww, Ds, Gg^Efm, Hh^Fds, Mm, Mm, Hh, Ds
Wwr, Ww^Wkf, Wwf, Ww^Wkf, Ww^Wkf, Ds^Ewsh, Ds, Hh^Fds, Hh^Em, Gg, Ds, Ds, Ds, Ww^Wkf, Wo, Wo, Wo, Wo, Ww^Ewl, Ww^Wkf, Ds, Ds, Hh^Fdw, Gg, Gs^Em, Hh, Hh, Wwr, Ww^Wkf, Wwf, Gs^Fmw, Hh, Hh^Fdw, Hh^Fdw, Ds^Es, Ds
Ds, Ds, Ds, Wo, Ww, Ds, Wwr, Wwf^Es, Ds, Ds, Wwr, Wwf^Es, Ww^Wkf, Ww^Wkf, Ww, Wo, Ww, Ww, Wwr, Wwr, Ds^Ewsh, Hh, Mm, Mm^Xm, Gs^Fmw, Mm, Ds, Wwr, Ww^Ewl, Ds, Ds, Gd^Fmw, Gg^Efm, Mm, Hh, Ds
Gd^Fdf, Gs^Em, Gg^Efm, Wwr, Ds, Ww, Ww, Wwf, Ww^Wkf, Wwr, Ww^Wkf, Ww^Ewl, Wwr, Ww, Wo, Ww, Wwf, Ww^Wkf, Ww^Wkf, Wwf, Ds, Gs^Fmw, Hh^Fdw, Mm, Mm, Gs, Ds, Wwf^Dr, Wwf^Es, Ww^Wkf, Wwf, Ds, Gs^Em, Gd, Hh^Fdw, Hh
Hh^Fdw, Gd^Emf, Gg^Ve, Gg, Ds, Wwf, Wwr, Ww, Ww^Ewf, Ww^Wkf, Ww, Ww, Wo, Wo, Wo, Ww^Wkf, Ww^Wkf, Wwr, Ww, Ds, Hh, Hh^Fds, Mm^Xm, Hh, Hh^Fdf, Gd^Emf, Gs^Em, Ds, Ds, Wwr, Ds, Ds^Ewsh, Hh^Fdw, Mm, Mm, Mm
Hh^Fds, Mm, Hh^Fdw, Gs^Fmw, Hh, Ds, Ds, Ds, Ds, Ww^Ewl, Wwr, Wwr, Wo, Wo, Ww, Wo, Ww^Ewf, Ww^Ewl, Wwr, Ds, Mm, Mm^Xm, Hh^Vhh, Mm, Hh^Fdw, Hh^Fdf, Gs^Fmw, Gg^Efm, Ds, Gg^Fet, Gs^Efm, Gg, Mm, Mm, Hh^Fdf, Hh^Fdw
Hh, Hh, Mm, Hh, Hh^Fdf, Hh^Es, Mm, Hh, Gg^Efm, Wwf^Es, Ds, Wwr, Ww, Wo, Wo, Ww^Wkf, Ww^Ewf, Wwr, Wwr, Ds, Hh, Mm, Hh^Fdw, Hh, Cte, Mm, Gs, Mm, Hh^Fdw, Hh^Fdf, Hh, Mm, Mm, Mm, Ds, Hh
Mm, Mm^Xm, Mm, Hh^Fds, Hh^Fdw, Gs^Fmw, Gs, Gd, Gs^Vo, Gd^Fdw, Hh, Ds, Ww, Wo, Ww^Wkf, Wo, Ww, Ww^Wkf, Wwf^Es, Wwf^Dr, Ds, Mm, Hh^Fds, Cte, 3 Kte, Cte, Gg, Gd, Gs^Vhr, Mm^Xm, Mm, Hh, Ds, Ds, Wwr, Ds
Hh^Fdw, Mm, Hh^Fdw, Hh, Mm, Mm, Mm, Hh^Es, Gg, Hh^Fdf, Ds, Ds, Wwf, Ww, Wo, Ww, Ww, Ww, Ww, Wwf, Wwr, Ds, Hh^Fdw, Cte, Cte, Cte^Edb, Gg, Gg^Efm, Gs^Em, Mm, Hh^Fdw, Gs, Ds^Es, Wwf^Dr, Ww^Ewl, Wo
Mm, Hh^Fdf, Hh, Gg^Efm, Hh^Fdw, Mm, Mm, Ds, Ds, Ds, Ww^Wkf, Wwr, Ww^Wkf, Ww, Wo, Wo, Ww^Ewl, Ww^Wkf, Wwf^Es, Ww^Wkf, Ww^Wkf, Ds^Es, Mm, Hh, Mm, Gd, Gs, Cte, Gg^Efm, Hh^Fds, Mm, Hh, Ds, Wwf^Es, Ww^Wkf, Wo
Hh, Mm, Hh, Gd^Em, Gg^Ve, Hh^Fdf, Hh, Ds, Wwf, Wwf^Es, Ww, Ww^Wkf, Wo, Ww, Ww, Ww^Ewl, Ww^Ewf, Ww^Wkf, Ww^Wkf, Wwr, Ww^Ewl, Ds, Mm, Mm, Mm, Mm, Hh, Gd^Emf, Hh^Fdf, Hh, Hh, Hh^Fdw, Gd^Em, Ds, Ds^Ewsh, Ww
Gs^Fds, Gs^Fmw, Gd, Gs, Gg^Efm, Gs, Hh, Wwr, Wwr^Dr, Wwr, Ww, Wwr, Wo, Wwr, Ww^Ewf, Wo, Wwr, Wwr, Ds, Wwr, Ds, Wwf, Hh, Mm, Gs, Gg^Efm, Hh^Vhh, Hh^Fdw, Mm, Hh, Gs^Fdw, Mm, Mm, Gs, Ds, Wwf
Ds, Ds, Wwf^Es, Ds, Ds, Ds^Es, Ds^Es, Ds, Ww^Wkf, Ww^Wkf, Wo, Wo, Wo, Wo, Wo, Ww^Wkf, Wwr, Ds, Mm, Mm^Xm, Mm, Ds^Ewsh, Cte, Gd^Em, Gs^Em, Hh, Hh^Es, Mm, Mm, Mm, Gg^Fet, Hh^Fds, Gs^Fmw, Gg^Edb, Hh^Fdf, Hh
Ww^Wkf, Wwr, Ww^Ewf, Ww^Ewl, Ww^Wkf, Wwr, Ww, Ww^Ewl, Wo, Ww^Ewl, Wo, Wo, Ww, Wo, Ww, Wwf, Ds, Ds^Ewsh, Mm^Xm, Mm, Mm, Hh^Fdw, Hh^Fdf, Hh^Fds, Hh^Em, Mm, Mm, Hh, Hh^Fds, Mm, Gs^Em, Gs^Fdw, Gs^Em, Gg^Efm, Gs, Hh^Fdw
Ds, Wo, Ds^Ewsh, Ds, Gg, Wwf, Ds, Wwf, Wwr, Ww, Ww^Ewf, Ww^Ewl, Wo, Wwr, Ww^Ewl, Ds, Hh, Mm, Mm, Mm, Mm, Mm, Hh, Hh^Em, Hh^Fdw, Gs, Gg^Edb, Gd^Fdw, Gs^Fdw, Gg^Efm, Mm, Hh^Es, Gg, Hh^Fds, Mm, Gd
Hh, Ds, Hh, Gs^Em, Gs^Fdw, Ds, Gs^Edb, Ds, Wwr, Ww^Wkf, Wwf, Ww^Wkf, Ww^Wkf, Ww^Wkf, Wwf, Wwr, Ds, Hh^Fdf, Hh^Em, Mm, Hh, Mm, Hh^Fdw, Mm, Mm^Xm, Hh^Vhhr, Gs^Edb, Hh, Gg^Edb, Gs^Edb, Gg^Efm, Hh, Gs^Fdf, Mm, Gg^Efm, Gs^Efm
Hh^Fds, Hh^Fds, Mm, Hh^Fdf, Gs^Fdf, Gg, Cer, Gg^Efm, Gs, Ds^Ewsh, Ds, Wwf^Dr, Ds, Wwr, Ds, Ds^Es, Gs^Fdw, Gg^Efm, Gs, Hh^Fdw, Mm, Hh^Fdw, Hh^Fdw, Mm, Mm, Mm, Hh, Gd^Em, Gs, Gs^Fdw, Hh^Fdw, Hh, Hh^Fdw, Gs^Fdw, Gs^Fds, Gg
Mm, Mm, Gs^Fmw, Gs^Vo, Gs^Em, Gg^Efm, Hh^Fdf, Hh, Gd^Emf, Ds, Gg^Fet, Ds, Gs^Fdw, Wwf, Hh^Es, Gs^Edb, Gd^Emf, Gd, Mm, Hh, Hh, Hh^Fds, Mm^Xm, Hh, Gg^Fet, Mm, Gd^Fdw, Gs^Em, Gg^Efm, Hh^Fdf, Mm^Xm, Mm, Mm, Hh^Fdf, Hh, Mm
Mm^Xm, Mm^Xm, Gs^Edb, Gg, Cer^Edb, Gd^Emf, Gs^Fdw, Cer, Cer, Gg, Gs^Edb, Gs^Em, Hh^Fdw, Gg, Gg^Efm, Gs, Hh^Fdf, Mm, Mm^Xm, Mm, Mm, Mm, Mm, Hh^Fdf, Gg^Efm, Gs^Fmw, Gg^Edb, Gs, Gg, Mm^Xm, Mm, Mm^Xm, Mm, Mm, Hh^Fdw, Mm
Hh, Hh^Fds, Gg, Cer^Edb, 2 Ker^Edb, Cer, Gd^Edb, Gs^Fds, Gg^Fet, Gs^Fdw, Gd^Edb, Hh^Vhhr, Hh, Gs, Hh, Hh^Em, Mm, Mm^Xm, Mm, Mm^Xm, Mm, Mm, Mm, Mm, Gd^Fdw, Gg^Edb, Gs^Fmw, Cer, Cer, Gs^Fmw, Gs^Fds, Mm, Mm, Mm, Mm^Xm, Hh
Gd, Gs, Gs^Em, Cer^Edb, Cer, Cer, Gs^Edb, Cer, Gs^Efm, Gg^Efm, Gs^Fdw, Gs^Em, Gs^Fdf, Gs^Fdw, Mm, Mm, Mm, Mm, Mm, Mm, Hh^Fdf, Mm, Hh, Gs, Gg^Wm, Gs^Vh, Gd^Emf, Cer, Hh, Gd^Emf, Gd^Edb, Hh, Hh, Hh^Vhh, Mm, Hh
Hh^Fdf, Hh, Gd^Emf, Gs^Fdf, Mm, Gg, Mm, Gd, Hh^Fdw, Mm, Hh, Gg, Gs^Fdw, Gs^Fds, Gg^Efm, Mm, Mm, Mm, Hh^Es, Hh^Fdw, Mm, Hh^Fdf, Gd^Em, Gg^Efm, Gg, Gs^Edb, Hh^Fdf, Hh^Es, Mm, Hh, Cer^Edb, Cer^Edb, Cer^Edb, Hh^Fdw, Hh^Fdf, Hh
Hh^Fdf, Gd^Vo, Gg, Hh, Mm, Mm, Mm, Gs^Fmw, Mm, Mm^Xm, Mm, Gs^Edb, Gd^Edb, Gg^Fet, Hh, Gs^Fdf, Hh^Vhh, Mm, Gd^Emf, Gs, Gg, Gs, Gs^Fdf, Gg^Ve, Hh, Cer, Gs^Fmw, Mm, Mm, Mm, Cer, 4 Ker, Re, Mm, Hh^Fdw, Hh
Mm, Gs^Fdw, Hh^Fdw, Mm, Mm, Mm, Hh^Fdf, Gs^Fdf, Mm, Mm, Hh^Fdw, Gs^Fmw, Hh, Gg^Efm, Gs^Fdw, Gg, Gg^Efm, Hh, Gs^Em, Gg^Wm, Gd^Fdw, Gs^Fmw, Gs^Fds, Mm, Ds^Es, Hh, Gs^Fdf, Hh, Mm, Hh^Es, Gd, Cer, Gg, Gs^Edb, Ds, Ds^Es
Mm, Mm, Mm, Hh, Hh^Fdw, Mm, Mm, Hh, Mm, Mm, Mm, Mm^Xm, Hh^Fdf, Mm, Mm, Hh^Es, Mm, Gg, Gs^Fmw, Gg, Ds^Es, Ds, Ww^Ewf, Ds, Wwr, Ds, Wwf^Es, Ds, Ds, Gs^Em, Ds^Ewsh, Ds, Ww^Ewl, Ds, Wwr, Ww
Hh, Mm, Mm, Mm^Xm, Mm^Xm, Hh^Fdf, Mm, Mm, Mm, Mm, Hh, Mm, Hh, Mm, Mm, Mm, Mm, Hh, Hh, Gg^Efm, Ds, Ww, Ww, Ww^Wkf, Wo, Ww^Ewl, Ww, Ww, Ww, Ds^Ewsh, Wwf, Wwf, Ww, Ww^Wkf, Wo, Wo
