Wo, Wo, Wwr, Wwr, Wo, Ww, Ds, Aa^Fda, Aa^Fma, Ai, Ai^Esa, Ha, Aa^Esa, Aa^Fpa, Rra, Ha, Ha^Fdw, Ms, Ms, Ha, Ms, Ha, Ms, Aa^Esa, Aa^Fma, Aa^Fpa, Ms, Ha, Ms, Aa, Aa^Fma, Aa, Aa^Fpa, Ai, Ww^Wkf, Wo, Wo, Wo
Wo, Wo, Wo, Ww^Wkf, Ww^Dr, Wwr, Ai, Aa^Fdw, Aa^Vca, Ha, Rra, Ai^Esa, Ai, Aa^Fda, Ms, Ai, Ms, Ms^Xm, Ms^Xm, Ms, Ms, Ms^Xm, Ms, Ai, Ai^Esa, Ms, Ms, Ms, Ha^Esa, Ha^Dr, Ms^Xm, Ms, Ha, Ai, Ds, Wwr, Ww, Wo
Wo, Wo, Ww, Ww, Wwr, Wwf, Aa^Esa, Aa, Cea^Esa, Aa^Esa, Aa^Fda, Ai^Ii, Aa^Feta, Ha, Ms, Ms^Xm, Ha^Es, Ha^Dr, Ha^Esa, Ha^Fdw, Ms, Ms, Ha, Ms, Aa, Ms^Xm, Ms, Ms, Ha, Ms^Xm, Ms, Ms, Ms^Xm, Ha^Em, Ms, Ai^Dr, Wwf^Es, Wwr
Wo, Wo, Ww^Wkf, Ww^Ewl, Ai, Aa^Fpa, Aa^Fda, Cea^Esa, 1 Ket, Cea, Aa^Fdw, Ai, Ha, Ha^Fda, Ha^Fdw, Ha, Ai, Ai^Esa, Aa^Fpa, Ha^Fma, Ha, Ms^Xm, Ms^Xm, Ha^Em, Aa^Fpa, Aa^Fdw, Ha^Fdw, Ha^Esa, Ms, Ha^Fdw, Aa^Fda, Aa, Ms, Ha^Esa, Ha^Em, Ai, Ww^Wkf, Wwr
Ww, Ww^Wkf, Wwr, Wwf^Es, Aa, Aa^Vla, Rra^Ii, Cea, Cea^Em, Cea^Esa, Rra^Em, Aa^Efm, Aa, Aa^Fma, Aa^Fda, Ms, Ai^Esa, Aa^Fma, Aa^Feta, Aa, Aa^Fda, Ms, Ms, Ms, Ms, Aa, Ha, Ms, Ms, Ms, Aa^Fpa, Ms, Ms, Ms, Aa, Wwf^Es, Ww^Ewl, Ww
Ai, Wwr, Ds, Ds, Ds^Es, Re, Gd, Gd^Efm, Gs, Hh^Esa, Re^Ii, Aa, Ai, Aa, Aa^Efm, Ha, Aa^Fma, Aa^Fdw, Ha^Fda, Ms, Aa^Fda, Aa^Fpa, Ha, Ms, Ms, Aa^Fdw, Aa^Fdw, Ms, Cva, Ms, Ha^Esa, Ms, Ha^Es, Ha, Aa^Fda, Ha, Ww^Dr, Wo
Aa^Fda, Aa^Fdw, Aa^Fpa, Aa^Fdw, Hh, Gs^Efm, Ha, Ai, Aa^Fda, Re^Es, Ai^Esa, Ai, Aa, Aa^Vea, Aa, Aa^Fdw, Aa^Fma, Aa^Fpa, Aa^Fpa, Aa^Fdw, Aa, Ai, Aa^Fma, Aa^Fpa, Aa^Vea, Aa^Fma, Aa^Fpa, Cva, Kva, Cva^Esa, Ha^Esa, Ms, Aa^Em, Aa^Fda, Ai^Esa, Ai, Ww^Wkf, Wwr
Ai, Ai, Ai, Aa^Fda, Aa^Fda, Aa^Fma, Aa^Vca, Aa, Hh, Re, Ai, Gs, Aa^Dr, Aa, Gd, Hh, Aa^Efm, Ai, Aa^Fda, Ha, Aa^Efm, Aa^Esa, Hh, Aa, Rra^Em, Aa, Aa^Em, Cva^Esa, Cva, Cva, Ha, Aa, Hh^Em, Wwf^Dr, Wwf, Wwr, Wwf^Es, Wwr
Aa^Fdw, Aa^Efm, Aa, Aa^Fma, Aa^Esa, Aa, Aa, Aa^Efm, Aa^Fpa, Aa^Fda, Aa, Aa, Ha, Aa^Fma, Aa^Fdw, Gs^Efm, Ai^Esa, Ai, Ai, Aa, Aa^Fdw, Aa^Fpa, Ai^Esa, Re, Re^Em, Rra, Aa^Fdw, Ha, Ms, Ha^Fdw, Aa^Vea, Aa, Aa^Fma, Ai, Aa^Feta, Aa, Aa^Es, Ds
Ha, Aa^Fda, Aa^Fpa, Aa^Fda, Ha^Fda, Ha^Esa, Aa^Fpa, Aa, Aa, Aa^Fma, Rra, Aa, Aa, Aa^Fda, Rra, Re^Esa, Aa, Aa^Dr, Re, Aa^Esa, Aa^Fda, Ai, Ai, Re^Em, Aa, Rra, Aa^Fpa, Ms, Ms^Xm, Aa^Fpa, Aa^Fdw, Aa^Fpa, Ms, Ha, Ms, Ms, Ha, Aa^Fma
Ms, Ha^Fda, Aa^Esa, Ha^Esa, Ms, Ms, Aa^Fdw, Aa^Fdw, Ha, Re^Efm, Gd^Emf, Aa^Fda, Aa^Feta, Aa, Gs^Efm, Aa, Aa^Fma, Re^Efm, Re^Em, Aa, Ha^Fdw, Aa^Fpa, Ai, Ai^Dr, Ai^Esa, Aa^Fpa, Ha, Ha, Ha, Ai, Aa, Aa^Fda, Aa^Fma, Ha^Fma, Ha, Ms, Ms^Xm, Ha
Aa^Fpa, Aa, Ha^Fdw, Ms, Ms^Xm, Ms^Xm, Ha^Es, Ms, Rra, Re^Em, Gs^Efm, Aa^Fpa, Aa^Fpa, Aa^Efm, Cha, Ai, Ai, Aa^Fma, Aa^Fdw, Aa^Fdw, Aa^Fpa, Aa^Fda, Aa^Fda, Ai^Esa, Aa^Vea, Ha, Ms, Ai, Aa^Efm, Aa^Fda, Ww, Ai, Aa^Fdw, Aa^Fpa, Aa^Fpa, Ms, Ms, Ms
Aa^Fda, Ha, Ms, Ms, Ms, Ms, Wo, Ai, Ai^Esa, Re, Ha^Vhha, Aa^Fpa, Aa^Efm, Aa, Re^Ii, Gs^Ii, Ai, Re^Em, Aa^Fma, Aa^Fma, Aa^Fma, Ha^Fdw, Aa^Fdw, Aa, Aa, Ha, Aa^Fda, Ai, Aa^Fda, Aa, Aa, Wo, Aa^Efm, Aa^Vea, Wo, Ai, Ha^Esa, Ha
Aa, Ai, Aa^Fma, Ha^Fdw, Ms, Ha, Ai, Ai^Esa, Aa^Fma, Hh, Ha^Em, Ha, Aa^Fma, Ai, Aa^Fda, Gs, Re^Em, Ai^Esa, Ai^Esa, Aa, Ai, Aa^Esa, Ai^Esa, Aa^Fda, Ha, Ai, Aa, Aa, Ha^Fma, Ha, Ms, Aa^Dr, Ha, Aa, Aa, Ww, Aa^Fda, Ms
Ms, Aa^Fda, Ai, Aa^Fda, Ha^Fdw, Ai^Es, Wo, Ha, Re, Gs^Efm, Gd^Emf, Wo, Aa^Fda, Aa^Fpa, Aa, Aa, Re^Esa, Ai, Ms, Ha, Re, Aa, Ai, Ai, Ms, Hh^Em, Re^Em, Aa^Dr, Aa^Fpa, Ms, Ms^Xm, Ms, Ha^Es, Hh^Es, Aa^Fdw, Aa, Ai, Aa^Fpa
Ms, Ha^Esa, Ha, Aa^Es, Aa, Aa^Fpa, Aa^Fda, Ww^Dr, Re^Es, Cha, Hh^Em, Gs^Tf, Re, Ai, Ai, Aa^Fma, Hh, Re^Dr, Aa, Ha^Fdw, Re, Aa^Fma, Aa, Aa, Aa^Em, Gd^Emf, Re^Es, Gs^Es, Aa^Fda, Hh, Ai, Ha^Fdw, Aa^Fpa, Ai, Aa^Fda, Aa^Efm, Ms, Ha
Ha^Esa, Ms, Ha, Ai, Aa^Feta, Aa^Fda, Aa^Vca, Aa, Aa^Fpa, Rra, Ms, Hh, Hh, Re^Em, Gs^Efm, Gd, Re, Aa^Fdw, Aa^Vha, Aa^Fpa, Aa^Efm, Aa^Efm, Ms, Aa^Feta, Aa, Gs^Efm, Aa^Efm, Re, Aa^Es, Ai, Aa^Fda, Aa^Fdw, Aa^Fdw, Ha, Ha^Fdw, Aa^Fdw, Ai, Ha
Aa^Esa, Ai^Esa, Ms^Xm, Ms, Ha, Aa, Rra, Ha, Aa^Fdw, Aa, Aa^Fda, Ha, Aa^Fpa, Gd^Ebn, Gd^Efm, Re, Aa, Aa^Fma, Aa, Aa^Es, Ai, Aa^Fpa, Ha, Aa^Fma, Aa^Efm, Aa, Aa^Fda, Aa, Ha, Aa^Em, Aa, Gd^Edb, Gs^Efm, Aa^Fpa, Ha^Vhha, Ms, Aa^Fpa, Ai
Ai, Ai, Ms, Ms^Xm, Aa, Aa^Fdw, Cha^Em, Cha^Em, Cha^Esa, Aa^Es, Aa^Vha, Ha, Aa, Aa, Aa, Ha, Hh, Ha, Ai^Esa, Ai^Esa, Aa^Fda, Ai, Aa, Aa^Fdw, Aa^Vea, Ai, Re, Gd, Ms^Xm, Ms, Gs^Es, Re^Es, Re^Ii, Ms, Ms, Ms, Ha, Aa^Efm
Ai, Ha, Ms, Ha, Aa^Fma, Ha^Fda, Cha^Esa, 3 Kha, Cha, Ha, Ai, Aa, Ha, Aa^Fpa, Cha, Hh, Gs^Efm, Aa, Aa, Gs^Esa, Hh, Aa, Gd^Ebn, Ai, Ai, Ai^Es, Ai^Esa, Aa, Aa^Fpa, Ha, Hh^Em, Re, Ms, Ms, Ms, Ha^Es, Ms, Ms
Aa, Ai^Esa, Aa, Aa^Fma, Aa^Fpa, Ms, Aa^Fdw, Cha^Esa, Ha, Ai^Esa, Aa, Ai, Aa^Esa, Aa^Fda, Hh, Gd^Ebn, Gd^Em, Re^Esa, Re^Esa, Re^Es, Re, Gd, Gs^Efm, Re^Em, Aa^Fpa, Ai, Re^Esa, Ai, Re^Esa, Ha^Vhha, Mv, Hh^Tf, Ms, Ms, Ms^Xm, Ha^Fdw, Ms, Ms
Ds, Aa^Fpa, Aa^Es, Aa^Fda, Ms, Ms, Aa^Fdw, Aa^Fda, Ai^Esa, Aa^Vla, Ai, Aa^Fma, Ha, Re, Gd^Esa, Ha, Ha^Es, Gs^Es, Aa, Ai^Es, Ai, Ai^Es, Ai, Re^Esa, Re^Esa, Hh, Gs^Efm, Re^Es, Gd^Dr, Qxu, Qxu^Ii, Ha, Ms, Ha^Vhha, Aa^Fpa, Ms, Aa^Fda, Aa^Fda
Ww, Wwf^Dr, Ha, Aa, Ai, Ha, Aa^Es, Aa^Feta, Aa^Fma, Ai, Aa^Fpa, Aa, Ai, Re^Es, Ai^Esa, Aa^Fda, Ha^Fdw, Ms, Ms, Ms^Xm, Ms, Aa, Ha^Vhha, Ai^Esa, Hh, Gs, Gd^Em, Re^Edb, Hh^Em, Hh^Tf, Mv, Ms^Xm, Mv, Ha^Em, Ms^Xm, Aa, Aa, Aa^Feta
Wo, Wwr, Ds^Es, Ms, Ha, Ai, Aa^Esa, Aa, Aa^Fda, Ha, Aa^Fma, Aa^Fda, Aa^Vha, Ai^Esa, Ai, Ai, Aa, Aa^Es, Ms, Ms, Ms^Xm, Ms, Ms, Ha, Ai, Aa, Gd^Ebn, Re^Ii, Cfr^Ebn, Cfr^Ecf, Cfr^Em, Ha, Qxu, Ms, Ms, Ms, Ha^Fdw, Aa
Wo, Ww^Wkf, Ai, Ha, Ai, Ai^Esa, Aa^Fpa, Ha, Aa^Fpa, Aa^Fdw, Aa, Aa^Esa, Aa, Aa, Re^Es, Aa, Aa^Fpa, Aa^Fda, Aa^Dr, Ha, Ms^Xm, Ms, Ms, Ms, Mv, Qxu, Gs^Es, Hh^Em, Cfr^Ebn, 2 Kfr, Cfr^Edb, Hh^Em, Qxu^Ii, Ms, Mv, Mv, Ha, Ai
Ww, Wwf^Es, Aa^Fdw, Aa^Fpa, Aa^Fda, Aa^Fda, Aa^Esa, Aa, Aa, Aa^Es, Aa^Fda, Ha, Aa^Es, Rra, Hh, Ha, Aa^Fda, Aa^Fpa, Aa, Aa^Feta, Aa^Fma, Ms, Ha, Hh^Es, Ql, Mv, Re^Es, Hh, Ql, Cfr^Edb, Hh^Edb, Qxu, Mv, Ql, Ms, Ms, Aa^Fpa, Aa^Fda
Wwr, Ww, Ww^Wkf, Aa, Ai, Aa^Fdw, Ha, Aa^Fda, Ai, Ha, Ha^Fda, Aa^Fda, Aa, Ai^Esa, Aa^Fpa, Ms, Aa, Aa^Fdw, Aa^Fdw, Aa^Fdw, Ha, Ms^Xm, Mv, Ql, Qxu, Ql, Re^Es, Gd^Edb, Gs^Efm, Mv, Ql, Mv, Aa^Fdw, Ai^Esa, Ai, Aa^Voa, Wwr, Ww^Wkf
Wo, Wo, Wo, Wwf, Ww, Ai^Esa, Ms, Ms, Ms, Ha^Fdw, Ms, Ms, Aa^Fpa, Ai, Aa^Fpa, Aa^Fdw, Aa^Fdw, Aa^Fda, Ha, Aa^Fda, Aa, Ha^Fda, Hh, Hh^Tf, Qxu, Ql, Hh, Re, Gs, Aa, Aa, Aa, Ww, Ww^Wkf, Ww, Ww^Dr, Wo, Wo
