Wo, Wo, Wo, Wo, Wo, Ww, Ds, Aa, Aa, Ai, Ai, Ai, Aa, Aa, Ai, Ha, Ha, Ms, Ms, Ha, Ha, Ha, Ms, Aa, Aa, Aa, Ms, Ha, Ms, Aa, Aa, Aa, Ai, Ai, Ww, Wo, Wo, Wo
Wo, Wo, Wo, Wo, Ww, Ww, Ai, Aa, Aa^Vca, Aa, Ai, Ai, Ai, Aa, Ms, Ai, Ms, Ms, Ms, Ha, Ha, Ha, Ms, Ha, Ha, Ms, Ms, Ms, Ha, Ha, Ms, Ms, Ha, Ai, Ds, Ww, Ww, Wo
Wo, Wo, Wo, Ww, Ww, Ww, Aa, Aa, Cea, Aa, Aa, Ai, Ai, Ha, Ms, Ms, Ha, Ha, Ha, Ha, Ms, Ms, Ha, Ha, Ha, Ms, Ms, Ha, Ha, Ms, Ms, Ms, Ms, Ha, Ms, Ai, Ww, Wo
Wo, Wo, Ww, Ww, Ai, Aa, Aa, Cea, 1 Ket, Cea, Aa, Ai, Ha, Ha, Ha, Ha, Ai, Ai, Aa, Ha, Ha, Ms, Ms, Ha, Ha, Ha, Ha, Ha, Ha, Ha, Aa, Aa, Ms, Ha, Ai, Ai, Ww, Wo
Ww, Ww, Ww, Ww, Aa, Aa^Vla, Re, Cea, Cea, Cea, Gs, Aa, Aa, Aa, Aa, Ha, Ai, Aa, Aa, Ms, Aa, Ms, Ms, Ha, Ms, Ms, Ha, Ha, Ms, Ms, Aa, Ms, Ms, Ms, Aa, Ai, Ww, Wo
Ai, Ww, Ds, Ww, Ds, Re, Gs, Gs, Gs, Gs, Re, Aa, Ai, Aa, Aa, Ha, Aa, Aa, Ha, Ms, Aa, Aa, Ha, Ms, Ms, Ha, Ha, Ha, Cva, Ms, Ha, Ms, Aa, Aa, Aa, Ai, Ww, Wo
Aa, Aa, Aa^Fpa, Aa^Fpa, Gs, Gs, Gs, Aa, Aa, Re, Ai, Ai, Aa, Aa^Vea, Aa, Aa, Aa^Fpa, Aa, Aa, Aa, Aa, Aa, Aa, Aa^Fpa, Aa^Vea, Ha, Ha, Cva, Kva, Cva, Ha, Ms, Aa, Aa, Ai, Ai, Ww, Wo
Ai, Ai, Ai, Aa^Fpa, Aa, Aa^Fpa, Aa^Vca, Aa, Gs, Re, Ai, Gs, Aa, Aa, Gs, Aa, Aa, Aa, Aa, Ha, Aa, Aa, Aa, Aa, Ai, Aa, Aa, Cva, Cva, Cva, Ha, Ha, Ms, Ww, Ww, Ww, Ww, Ww
Aa, Aa, Aa, Aa, Aa, Aa, Aa, Aa, Aa, Aa, Aa, Aa, Aa, Aa^Fpa, Aa^Fpa, Gs, Ai, Aa, Aa, Aa, Aa, Aa^Fpa, Ai, Ai, Ai, Ai, Aa^Fpa, Ha, Ha, Ha, Aa^Vea, Ha, Ha, Ai, Aa, Aa, Aa, Ds
Ha, Aa, Aa, Aa, Ha, Ha, Ha, Aa, Aa, Aa, Re, Aa, Aa, Aa, Gs, Re, Aa, Aa, Re, Aa, Aa^Fpa, Ai, Ai, Ai, Ai, Ai, Aa^Fpa, Ha, Ha, Aa^Fpa, Aa, Aa^Fpa, Ha, Ha, Ms, Ms, Ha, Aa
Ms, Ha, Aa, Ms, Ms, Ms, Aa, Aa, Aa, Re, Gs, Aa, Aa, Aa, Gs, Aa, Aa, Re, Re, Aa, Aa^Fpa, Aa^Fpa, Ai, Ai, Ai, Aa^Fpa, Aa^Fpa, Ha, Aa^Fpa, Aa^Fpa, Aa, Aa^Fpa, Aa^Fpa, Ha, Ha, Ms, Ms, Ha
Aa, Aa, Ms, Ms, Ms, Ms, Ai, Ai, Ai, Gs, Gs, Aa^Fpa, Aa^Fpa, Aa, Gs, Ai, Ai, Aa, Aa, Aa, Aa^Fpa, Aa^Fpa, Aa^Fpa, Ai, Aa^Vea, Aa^Fpa, Aa^Fpa, Aa^Fpa, Aa^Fpa, Aa^Fpa, Aa^Fpa, Aa^Fpa, Aa^Fpa, Aa^Fpa, Aa^Fpa, Ms, Ms, Ha
Aa, Ha, Ms, Ms, Ms, Ms, Ai, Ai, Ai, Re, Ha^Vhha, Aa^Fpa, Aa, Aa, Re^Ii, Gs^Ii, Ai, Re, Aa, Aa, Aa^Fpa, Ha, Aa, Aa, Aa, Aa^Fpa, Aa^Fpa, Aa^Fpa, Aa^Fpa, Aa^Fpa, Aa^Fpa, Aa^Fpa, Aa^Fpa, Aa^Vea, Aa, Ai, Ha, Ha
Aa, Ms, Aa, Ha, Ai, Ha, Ai, Ai, Aa, Gs, Ha, Ha, Aa, Ai, Aa, Gs, Re, Ai, Ai, Aa, Aa, Aa, Ai, Aa, Ha, Aa, Aa, Aa^Fpa, Aa^Fpa, Aa^Fpa, Aa^Fpa, Aa^Fpa, Ha, Aa, Aa, Aa, Aa, Ms
Aa, Aa, Aa, Aa, Aa, Ai, Aa, Ai, Re, Gs, Gs, Ha, Aa, Aa, Aa, Aa, Re, Ai, Ms, Ha, Re, Aa, Ai, Ai, Ha, Ha, Re, Aa^Fpa, Aa^Fpa, Aa^Fpa, Aa^Fpa, Aa^Fpa, Ha, Ha, Aa, Aa, Aa, Aa
Ha, Ha, Ha, Aa, Aa, Aa, Aa, Aa, Re, Gs, Gs, Re, Re, Ai, Ai, Aa, Gs, Re, Aa, Ha, Re, Aa, Aa, Aa, Aa, Ai, Re, Gs, Aa, Aa^Fpa, Aa, Aa^Fpa, Aa^Fpa, Aa, Ha, Aa, Ms, Ha
Ai, Ha, Ha, Ai, Aa, Aa, Aa^Vca, Aa, Aa^Fpa, Re, Ha, Gs, Gs, Re, Gs, Gs, Re, Aa, Aa^Vha, Aa, Aa, Aa, Ms, Aa, Aa, Gs, Aa, Re, Aa, Aa, Aa, Aa, Aa, Ha, Ha, Aa, Ai, Ha
Ai, Ai, Ms, Ms, Ha, Aa, Ha, Ha, Aa, Aa, Ms, Ha, Gs, Gs, Gs, Gs, Aa, Aa, Aa, Aa, Ai, Aa^Fpa, Ha, Aa^Fpa, Aa^Fpa, Aa, Aa, Aa, Ha, Aa, Aa, Gs, Gs, Aa^Fpa, Ha^Vhha, Ms, Ha, Ai
Ai, Ai, Ms, Ms, Aa, Aa, Cha, Cha, Cha, Aa, Aa^Vha, Ha, Aa, Aa, Aa^Fpa, Gs, Gs, Ha, Ai, Ai, Aa, Ai, Ai, Aa^Fpa, Aa^Vea, Ai, Re, Gs, Ms, Ms, Gs, Re, Re^Ii, Ms, Ms, Ms, Ms, Ha
Ai, Ha, Ms, Ha, Aa, Ha, Cha, 3 Kha, Cha, Aa, Aa, Aa, Aa, Aa^Fpa, Gs, Gs, Gs, Aa, Aa, Gs, Gs, Aa, Gs, Ai, Ai, Ai, Ai, Aa^Fpa, Aa^Fpa, Ha, Ms, Re, Ms, Ms, Ms, Ms, Ms, Ha
Ds, Ai, Aa, Aa, Aa^Fpa, Ms, Aa, Cha, Aa, Aa, Aa, Aa, Aa, Aa^Fpa, Gs, Gs, Gs, Re, Re, Re, Re, Gs, Gs, Re, Aa^Fpa, Ai, Re, Ai, Re, Ha^Vhha, Qxu, Ms, Ms, Ms, Ms, Ha, Ms, Ms
Ds, Ai, Aa, Aa, Ha, Ms, Aa, Aa, Ai, Aa^Vla, Ai, Aa, Ha, Re, Gs, Ha, Ha, Gs, Aa, Ai, Ai, Ai, Ai, Gs, Gs, Gs, Gs, Re, Re, Qxu, Qxu^Ii, Ha, Ms, Ha^Vhha, Aa^Fpa, Ms, Aa^Fpa, Aa
Ww, Ww, Aa, Aa, Ai, Ha, Aa, Aa^Fpa, Aa^Fpa, Ai, Aa^Fpa, Ai, Ai, Re, Ai, Gs, Ha, Ms, Ms, Ms, Ms, Aa, Ha^Vhha, Ai, Ai, Gs, Re, Re, Hh, Hh, Mv, Ms, Mv, Ha, Ms, Aa^Fpa, Aa, Aa
Wo, Ww, Ds, Ms, Ha, Ai, Aa, Aa^Fpa, Aa, Aa^Fpa, Aa^Fpa, Aa^Fpa, Aa^Vha, Ai, Ai, Ai, Aa, Aa, Ms, Ms, Ms, Ms, Ms, Ha, Ai, Gs, Gs, Re^Ii, Cfr^Ebn, Cfr^Ecf, Cfr, Ms, Qxu, Ms, Ms, Ms, Ha, Aa
Wo, Ww, Ai, Ha, Ai, Ai, Aa, Aa, Aa^Fpa, Aa, Aa, Aa, Aa, Aa, Ai, Aa, Aa^Fpa, Aa^Fpa, Aa^Fpa, Ha, Ms, Ms, Ms, Ms, Mv, Mv, Gs, Hh, Cfr^Ebn, 2 Kfr, Cfr, Hh, Qxu^Ii, Ms, Mv, Mv, Ha, Aa
Wo, Ww, Aa, Aa, Aa, Aa, Aa, Aa, Aa, Aa, Aa, Aa, Aa, Ai, Aa, Aa, Aa^Fpa, Aa^Fpa, Aa, Aa^Fpa, Aa, Ms, Ha, Ms, Ql, Mv, Re, Hh, Ql, Cfr, Hh, Qxu, Mv, Ql, Ms, Ms, Aa, Aa
Wo, Ww, Ww, Aa, Ai, Aa, Ha, Aa, Ai, Aa, Ha, Aa, Aa, Ai, Aa, Aa, Aa, Aa, Aa, Aa, Ha, Ms, Ms, Ql, Qxu, Ql, Re, Gs, Gs, Mv, Ql, Mv, Aa, Ai, Ai, Aa^Voa, Ww, Ww
Wo, Wo, Wo, Ww, Ww, Ai, Ai, Ai, Ai, Ha, Ms, Ms, Aa, Ai, Aa, Aa, Aa, Aa, Ha, Aa, Aa, Ha, Ms, Mv, Qxu, Ql, Re, Re, Gs, Aa, Aa, Aa, Ww, Ww, Ww, Ww, Wo, Wo
