Wo, Ww, Wwr, Ww, Ds, Ai, Ai, Hh, Hh, Aa, Aa, Hh, Mm, Mm, Mm^Xm, Mm, Mm, Mm, Mm, Mm, Mm^Xm, Gg, Hh, Hh, Gs^Fdw, Aa, Aa, Hh, Hh, Ai, Aa, Aa, Hh, Hh, Hh, Gs^Fdw, Gs^Fdw, Hh, Hh, Mm, Isa, Isa, Isa, Hh
Ww, Ww, Ds, Wwf, Ds, Aa, Aa, Hh, Gg, Aa, Gd, Ai, Hh, Mm, Mm^Xm, Mm^Xm, Mm, Mm, Mm, Mm, Hh, Hh, Ai, Mm, Hh, Gd, Gs^Fdw, Hh, Gg, Gd, Ai, Aa, Gd, Aa, Gs^Fetd, Gs^Fdw, Gs^Fetd, Mm, Mm, Mm^Xm, Cer, Isr, Hh, Isa
Ds, Ds, Ce, Ce, Ce, Gs^Fp, Gs^Fp, Gd, Gg^Ve, Gg, Hh, Gs^Fp, Gs^Fp, Mm, Hh, Mm, Mm, Mm, Mm, Mm, Mm^Xm, Mm^Xm, Aa, Aa, Gd, Gg, Gg, Gs^Qov, Mm, Mm, Hh, Hh, Mm, Gs^Fp, Gs^Fdw, Gg, Gs^Vl, Gd, Hh, Cer, 2 Ker, Cer, Hh, Mm
Gs^Fp, Gg, Ce, 1 Ket, Ce, Gs^Fp, Gg, Gg, Gg, Aa, Mm, Mm^Xm, Mm, Gs^Fp, Aa, Hh, Mm, Mm, Mm, Mm, Mm, Mm, Gs^Fp, Gg^Ve, Gg, Gs^Qov, Hh, Mm, Mm, Mm, Mm, Mm, Mm, Mm, Gg, Gs^Qov, Gd, Hh, Mm, Cer, Cer, Cer, Isr, Gg
Hh, Hh, Mm, Ce, Hh, Aa, Hh, Gg, Gs^Fp, Hh, Hh^Vhh, Mm, Mm, Hh, Gg, Mm, Mm, Mm, Mm, Mm, Mm, Hh, Gg, Gg, Gg, Gs^Qov, Mm^Xm, Mm^Xm, Mm, Mm, Mm, Mm, Mm, Hh, Hh, Gg, Hh, Isa, Isr, Hh, Isa, Isa, Isa, Hh
Gg, Aa, Aa, Mm^Xm, Gs^Fp, Hh, Mm, Aa, Gg, Hh, Ai, Mm, Aa, Gg, Hh, Gg, Hh, Mm, Hh, Hh^Vhh, Aa, Aa, Gg, Mm, Hh, Gg, Mm, Mm^Xm, Mm, Mm, Mm, Mm, Mm^Xm, Mm^Xm, Mm^Xm, Aa, Hh, Hh, Isa, Isa, Gd, Rp^Vhcr, Isa, Gd
Ds, Gs^Fp, Gg, Gs^Fp, Gs^Fp, Hh^Vhh, Gg, Hh, Gd, Gs^Fp, Gs^Fp, Aa, Gs^Fp, Gs^Fp, Mm, Gg, Gs^Fp, Gs^Fp, Gs^Fp, Gd, Gd, Gd, Gg, Hh, Gs^Fp, Aa, Aa, Mm, Mm, Mm, Mm, Mm, Mm, Mm, Gs^Fdw, Gs^Fetd, Gg, Gd, Gs^Qov, Gg, Gs^Fdw, Hh, Hh, Hh
Ww, Ds, Ds, Hh, Gg, Gg, Hh, Ai, Aa, Gs^Fp, Gs^Fp, Gs^Fp, Gg, Hh, Hh, Gg, Ai, Hh, Hh, Hh, Gg, Gs^Qov, Gg, Gs^Fp, Gs^Fp, Hh, Gs^Fp, Hh, Mm, Mm, Mm, Hh^Vhh, Aa, Aa, Gg, Gs^Fdw, Gs^Qov, Gg, Gg, Gg, Hh, Mm, Ai, Aa
Wwr, Ds, Wwf, Gs, Gg, Aa, Gd, Aa, Gg, Hh, Gg, Gs^Vl, Gd, Gs^Fdw, Gs^Fp, Gg, Aa, Ai, Gs^Fp, Aa, Gs^Fp, Gg, Gg, Gg^Ve, Gs^Fp, Aa, Mm, Gg, Gs, Mm^Xm, Gs^Fp, Hh, Aa, Hh, Gg, Gs^Qov, Hh, Aa, Gs^Vo, Gg, Gs, Gg, Hh, Aa
Wo, Ww, Wwf, Ds, Gg, Gg, Gg, Gg, Gs, Gd, Gd, Gg, Gg, Gd, Gg, Gg, Gd, Gs^Fp, Gs^Fp, Gs^Fp, Hh, Gg, Gd, Gs^Fdw, Hh, Hh, Hh, Hh, Gg, Gs^Fp, Gs^Qov, Gs^Fdw, Gd, Gs^Fp, Gg, Gg, Gg, Gg, Gs^Fp, Gg, Aa, Mm, Mm^Xm, Hh
Wo, Ww, Ww, Ds, Ds, Ds, Gs^Fp, Aa, Aa, Ai, Gd, Gs^Fdw, Gg, Gg, Gg, Gg, Gg, Gd, Hh, Gg, Gg, Gd, Ai, Aa, Aa, Ai, Gd, Gs, Gg, Gs^Qov, Gg, Gg, Gg, Gg, Hh^Qov, Aa, Gs^Fdw, Gs^Fdw, Hh, Gg, Mm, Hh, Mm, Mm^Xm
Wo, Wo, Ww, Wwr, Ds, Gs^Fp, Gs^Fp, Aa, Hh, Aa, Aa, Hh, Gs^Fp, Hh, Gg, Gs^Vh, Gg, Gg, Gg, Mm, Gg, Gs, Gd, Aa, Gg, Gg, Gs^Qov, Gg, Gg, Gg, Hh, Gg, Gg, Gs^Qov, Hh, Hh^Vhh, Gg, Gs^Fp, Gg, Aa, Mm, Mm, Mm, Mm
Wo, Wo, Wwr, Wwf, Wwr, Ds, Gg, Hh, Hh, Mm, Gs^Fp, Gs^Fp, Aa, Gs^Fp, Hh, Gg, Hh, Mm, Hh, Gg, Aa, Hh, Aa, Gg, Gg, Gs^Fdw, Gg, Gg, Gs^Qov, Gs^Qov, Gs^Fp, Gs^Fdw, Aa, Gg, Gg, Gs^Fp, Gg, Gs^Qov, Gg, Hh, Hh, Mm^Xm, Mm, Hh
Wo, Wo, Wo, Ww, Ww, Ds, Ds, Gg, Ds, Gg, Gs^Fp, Gs^Fp, Ai, Aa, Chr, Chr, Chr, Hh, Mm, Gg, Gg, Aa, Gs^Fp, Gg, Gs^Vh, Gg, Gg, Mm, Gs^Fdw, Gg, Gs^Vh, Gs^Fp, Hh, Aa, Hh, Gs^Fp, Isa, Gs^Fdw, Gs^Fp, Aa, Aa, Mm, Mm, Mm
Wo, Wo, Wwr, Ww, Ww, Ds, Ww, Wwf, Ds, Ds, Aa, Gg, Gs^Vh, Hh, Chr, 3 Khr, Chr, Mm^Xm, Gs, Gs, Hh, Gg, Gg, Gs^Fp, Gg, Hh^Qov, Gg, Hh, Hh, Gg, Gs^Fp, Gg, Hh, Gd, Isr, Isa, Rp^Vhcr, Gd, Mm, Hh, Aa, Ai, Mm, Mm
Wo, Wo, Wwr, Wwf, Ww, Ww, Ww, Wwr, Ds, Hh, Aa, Ai, Gs^Fp, Gs^Fp, Gs^Fdw, Chr, Gs^Fp, Hh, Gd, Mm, Hh, Gs^Fdw, Gg, Gg, Gg, Gs^Fp, Ai, Mm, Aa, Ai, Hh, Mm, Mm, Hh, Hh, Isa, Isa, Isr, Hh, Mm, Gd, Isa, Hh, Mm
Wo, Wo, Wo, Ww, Wo, Wwr, Ww, Ww, Ds, Gg, Gs^Fp, Gg, Hh, Gs^Fp, Gg, Gd, Gg, Gg, Aa, Gd, Gg, Gg, Gs^Fp, Gs^Vl, Gg, Hh, Hh, Aa, Mm, Isa, Gd, Mm, Isa, Hh, Isa, Isa, Cer, Cer, Cer, Isa, Rp^Vhcr, Gs^Fdw, Mm, Hh
Wo, Wo, Wo, Wo, Wo, Ww, Ds, Wwr, Wwf, Ds, Ds, Gg, Gg, Gg, Gg, Aa, Hh, Aa, Hh, Aa, Gg, Gs^Fp, Aa, Gs^Fp, Mm^Xm, Mm, Mm, Mm, Mm, Mm^Xm, Hh^Vhh, Isa, Isa, Isr, Isa, Mm, Cer, 5 Ker, Cer, Isa, Isr, Isa, Mm, Mm
Wo, Wo, Wo, Wo, Wo, Ww, Ww, Ww, Ww, Ds, Wwr, Ds, Ds, Ds, Gg, Hh, Mm, Mm, Hh, Ai, Gg, Aa, Hh, Hh, Mm, Mm^Xm, Mm, Mm, Mm, Mm, Mm, Hh, Ai, Gd, Mm, Hh, Hh, Cer, Ai, Hh, Mm^Xm, Isa, Aa, Hh
Wo, Wo, Wo, Wo, Wo, Wo, Wo, Wo, Wo, Ww, Ww, Ww, Ww, Ds, Ds, Hh, Mm, Mm, Mm, Mm, Hh, Gg, Hh, Mm, Mm, Mm, Mm^Xm, Mm, Mm, Mm, Mm, Hh, Hh, Aa, Aa, Isa, Hh, Aa, Hh, Mm, Mm, Hh, Ai, Aa
