Ww, Ww, Wwr, Ww, Ds, Ds, Ds, Hh, Hh, Gg, Gg, Hh, Mm, Mm, Mm, Mm, Mm, Mm, Mm, Mm, Mm, Gg, Hh, Hh, Gg, Gg, Gg, Hh, Hh, Gg, Gg, Gg, Hh, Hh, Hh, Gg, Gg, Hh, Hh, Gg, Gg, Gg, Gg, Gg
Ww, Ww, Ds, Wwf, Ds, Gg, Gg, Hh, Gg, Gg, Gg, Gg, Gg, Mm, Mm, Mm, Mm, Mm, Mm, Mm, Hh, Hh, Gg, Mm, Hh, Gg, Gg, Hh, Gg, Gg, Gg, Gg, Gg, Gg, Gg, Gg, Gg, Mm, Mm, Hh, Cer, Gg, Hh, Gg
Ds, Ds, Gg, Gg, Gg, Gg, Gg, Gg, Gg^Ve, Gg, Hh, Gg, Gg, Mm, Hh, Mm, Mm, Mm, Mm, Mm, Mm, Mm, Gg, Gg, Gg, Gg, Gg, Gg, Mm, Mm, Hh, Hh, Mm, Gg, Gg, Gg, Gs^Vl, Gg, Hh, Cer, 2 Ker, Cer, Hh, Mm
Ds, Gg, Ce, Ce, Ce, Gg, Gg, Gg, Gg, Gg, Mm, Mm, Mm, Gg, Gg, Hh, Mm, Mm, Mm, Mm, Mm, Mm, Gg, Gg^Ve, Gg, Gg, Hh, Mm, Mm, Mm, Mm, Mm, Mm, Mm, Gg, Gg, Gg, Gg, Hh, Cer, Cer, Cer, Gg, Gg
Hh, Hh, Ce, 1 Ket, Ce, Gg, Hh, Gg, Gg, Hh, Hh^Vhh, Mm, Mm, Hh, Gg, Mm, Mm, Mm, Mm, Mm, Mm, Hh, Gg, Gg, Gg, Gg, Mm, Mm, Mm, Mm, Mm, Mm, Mm, Hh, Hh, Gg, Hh, Gg, Gg, Hh, Gg, Gg, Gg, Hh
Gg, Gg, Gg, Ce, Gg, Hh, Mm, Gg, Gg, Hh, Gg, Mm, Gg, Gg, Hh, Gg, Hh, Mm, Hh, Hh^Vhh, Gg, Gg, Gg, Mm, Hh, Gg, Mm, Mm, Mm, Mm, Mm, Mm, Mm, Mm, Mm, Gg, Hh, Hh, Gg, Gg, Gg, Gs^Vo, Gg, Gg
Ds, Gg, Gg, Gg, Gg, Hh^Vhh, Gg, Hh, Gg, Gg, Gg, Gg, Gg, Gg, Mm, Gg, Gg, Gg, Gg, Gg, Gg, Gg, Gg, Hh, Gg, Gg, Gg, Mm, Mm, Mm, Mm, Mm, Mm, Mm, Gg, Gg, Gg, Gg, Gg, Gg, Gg, Gg, Gg, Gg
Ww, Ds, Ds, Hh, Gg, Gg, Hh, Gg, Gg, Gg, Gg, Gg, Gg, Hh, Hh, Gg, Gg, Hh, Hh, Hh, Gg, Gg, Gg, Gg, Gg, Hh, Gg, Hh, Mm, Mm, Mm, Hh^Vhh, Gg, Gg, Gg, Gg, Gg, Gg, Gg, Gg, Hh, Hh, Gg, Gg
Ww, Ds, Wwf, Ds, Gg, Gg, Gg, Gg, Gg, Gg, Gg, Gs^Vl, Gg, Gg, Gg, Gg, Gg, Gg, Gg, Gg, Gg, Gg, Gg, Gg^Ve, Gg, Gg, Mm, Gg, Gg, Mm, Gg, Hh, Gg, Hh, Gg, Gg, Gg, Gg, Gs^Vo, Gg, Gg, Gg, Hh, Gg
Ww, Ww, Wwf, Ds, Gg, Gg, Gg, Gg, Gg, Gg, Gg, Gg, Gg, Gg, Gg, Gg, Gg, Gg, Gg, Gg, Gg, Gg, Gg, Gg, Hh, Hh, Hh, Hh, Gg, Gg, Gg, Gg, Gg, Gg, Gg, Gg, Gg, Gg, Gg, Gg, Gg, Mm, Mm, Hh
Ww, Ww, Ww, Ds, Ds, Ds, Gg, Gg, Gg, Gg, Gg, Gg, Gg, Gg, Gg, Gg, Gg, Gg, Hh, Gg, Gg, Gg, Gg, Gg, Gg, Gg, Gg, Gg, Gg, Gg, Gg, Gg, Gg, Gg, Hh, Gg, Gg, Gg, Hh, Gg, Mm, Hh, Mm, Mm
Ww, Ww, Ww, Wwr, Ds, Gg, Gg, Gg, Hh, Gg, Gg, Gg, Gg, Gg, Gg, Gs^Vh, Gg, Gg, Chr, Mm, Gg, Gg, Gg, Gg, Gg, Gg, Gg, Gg, Gg, Gg, Gg, Gg, Gg, Gg, Hh, Hh, Gg, Gg, Gg, Gg, Mm, Mm, Mm, Mm
Ww, Ww, Ww, Ww, Wwf, Ds, Gg, Hh, Hh, Mm, Gg, Gg, Gg, Gg, Mm, Gg, Hh, Chr, 3 Khr, Chr, Gg, Hh, Gg, Gg, Gg, Gg, Gg, Gg, Gg, Gg, Gg, Gg, Gg, Gg, Gg, Gg, Gg, Gg, Gg, Hh, Hh, Mm, Mm, Hh
Ww, Ww, Ww, Ww, Ww, Ds, Ds, Gg, Ds, Gg, Gg, Gg, Gg, Gg, Hh, Hh, Mm, Chr, Chr, Chr, Gg, Gg, Gg, Gg, Gg, Gg, Gg, Hh, Gg, Gg, Gs^Vh, Gg, Hh, Gg, Gg, Gg, Gg, Gg, Gg, Gg, Gg, Mm, Mm, Mm
Ww, Ww, Ww, Ww, Ww, Ds, Ww, Wwf, Ds, Ds, Gg, Gg, Gs^Vh, Gg, Gg, Gg, Mm, Mm, Gg, Gg, Hh, Gg, Gg, Gg, Gg, Hh, Gg, Hh, Hh, Gg, Gg, Gg, Hh, Gg, Gg, Gg, Gs^Vo, Gg, Gg, Gg, Gg, Gg, Hh, Mm
Ww, Ww, Ww, Ww, Ww, Ww, Ww, Wwr, Ds, Hh, Gg, Gg, Gg, Gg, Gg, Hh, Gg, Hh, Gg, Mm, Hh, Gg, Gg, Gg, Gg, Gg, Gg, Mm, Gg, Gg, Hh, Mm, Mm, Hh, Hh, Gg, Gg, Gg, Hh, Gg, Gg, Gg, Hh, Mm
Ww, Ww, Ww, Ww, Ww, Ww, Ww, Ww, Ds, Gg, Gg, Gg, Hh, Gg, Gg, Gg, Gg, Gg, Gg, Gg, Gg, Gg, Gg, Gs^Vl, Gg, Hh, Hh, Gg, Mm, Gg, Gg, Mm, Gg, Hh, Gg, Gg, Cer, Cer, Cer, Gg, Gs^Vl, Gg, Mm, Hh
Ww, Ww, Ww, Ww, Ww, Ww, Ww, Wwr, Wwf, Ds, Ds, Gg, Gg, Gg, Gg, Gg, Hh, Gg, Hh, Gg, Gg, Gg, Hh, Gg, Mm, Hh, Mm, Mm, Mm, Mm, Hh^Vhh, Gg, Gg, Gg, Gg, Mm, Cer, 4 Ker, Cer, Gg, Gg, Gg, Mm, Mm
Ww, Ww, Ww, Ww, Ww, Ww, Ww, Ww, Ww, Ds, Wwr, Ds, Ds, Ds, Gg, Hh, Mm, Mm, Hh, Gg, Gg, Gg, Hh, Hh, Mm, Mm, Mm, Mm, Mm, Mm, Mm, Hh, Gg, Gg, Gg, Hh, Hh, Cer, Gg, Hh, Mm, Gg, Gg, Hh
Ww, Ww, Ww, Ww, Ww, Ww, Ww, Ww, Ww, Ww, Ww, Ww, Ww, Ds, Ds, Hh, Mm, Mm, Mm, Mm, Hh, Gg, Hh, Mm, Mm, Mm, Mm, Mm, Mm, Mm, Mm, Hh, Hh, Gg, Gg, Gg, Gg, Gg, Hh, Mm, Mm, Hh, Gg, Gg
