Mm, Hh, Gg, Gg, Hh, Mm, Mm, Mm, Mm, Mm, Hh, Hh, Hh, Hh, Gg, Hh, Gg, Mm, Mm, Wo, Ww, Ww, Ww, Hh
Hh, Hh, Gg, Gs^Fp, Gs^Fp, Hh, Mm, Mm, Mm, Mm, Mm, Mm, Mm, Mm, Hh, Gs^Fp, Gg, Hh, Ww, Ww, Hh, Wo, Wo, Ww
Ww, Ww, Gg, Gs^Fp, Gs, Gg, Gg, Mm, Mm, Mm, Mm, Mm, Gg, Mm, Gg, Gs^Fp, Ww, Gg, Gg, Gs^Fp, Gs^Fp, Hh, Wo, Wo
Hh, Gg, Gg, Gs, Gg, Gg, Gs^Fp, Hh, Hh, Mm, Hh, Hh, Hh, Gg, Gs^Fp, Ww, Ww, Gg, Hh, Gg, Gg, Gg, Ww, Ww
Gs^Fp, Gs^Fp, Gg, Gg, Gg, Gg, Gg, Gg, Gg, Hh, Gs^Fp, Gs^Fp, Gs^Fp, Gg, Gg, Hh, Gg, Gg, Hh, Hh^Vhh, Hh, Gg, Gs^Fp, Hh
Gg, Gs^Fp, Gg, Hh, Gg, Gg, Gg, Gg, Gs^Fp, Gg, Gg, Gs^Fp, Gg, Gg, Hh, Gg, Hh, Gg, Gs^Fp, Gg, Gg, Hh, Gs^Fp, Gs^Fp
Hh, Gg, Gs^Fp, Gg, Ww, Gg, Gg, Gg, Gg, Gs^Fp, Gg, Gg, Gs^Fp, Gg, Mm, Hh, Mm, Hh, Hh, Hh, Gg, Gg, Gg, Gg
Hh, Mm, Mm, Hh, Gs^Fp, Hh, Gs^Fp, Gg, Ww, Hh, Ww, Gg, Gg, Hh, Mm, Mm, Mm, Mm, Mm, Mm, Mm, Hh, Hh, Gs^Fp
Mm, Hh, Mm, Mm, Hh, Gg, Gg, Gg, Gg, Wo, Gg, Gg, Hh, Hh^Vhh, Mm, Mm, Mm, Mm, Mm, Mm, Mm, Mm, Mm, Hh
Hh, Mm, Mm, Mm, Mm, Gs^Fp, Hh, Gg, Ww, Ww, Gg, Gs^Fp, Mm, Mm, Mm, Mm, Mm, Mm, Mm, Mm, Hh, Mm, Mm, Mm
Mm, Mm, Mm, Mm, Mm, Gs^Fp, Gs^Fp, Gg, Mm, Hh, Gs^Fp, Mm, Mm, Mm, Mm, Mm, Mm, Mm, Mm, Mm, Mm, Mm, Mm, Mm
Mm, Mm, Mm, Mm, Gs^Fp, Gs^Fp, Gs^Fp, Gg, Gg, Gg, Gs^Fp, Hh, Hh, Hh, Hh, Mm, Mm, Mm, Mm, Mm, Mm, Mm, Mm, Hh
Mm, Mm, Mm, Hh, Gs^Fp, Hh, Gg, Gg, Gs^Fp, Gg, Gg, Gs^Fp, Gg, Gs^Fp, Hh, Mm, Hh, Mm, Mm, Mm, Mm, Mm, Hh, Mm
Hh, Hh, Hh, Hh, Gg, Gs^Fp, Gs^Fp, Gg^Ve, Gg, Gg, Gg, Ww, Gg, Hh, Gs^Fp, Gg, Gg, Gg, Gg, Mm, Gs^Fp, Hh, Gs^Fp, Mm
Gs^Fp, Gg, Gs^Fp, Gs^Fp, Ww, Ww, Hh, Gs^Fp, Gg, Ww, Gg, Gg, Gg, Gg, Gs^Vo, Hh, Gg, Hh, Gs^Fp, Gs^Fp, Gs^Fp, Gs^Fp, Gg, Hh
Hh, Hh, Gg, Gs^Fp, Gg, Wo, Hh, Hh, Gg, Ww, Ww, Hh, Ww, Gg, Gg, Mm, Gg, Gs^Fp, Gs^Fp, Gg, Gg, Gg, Hh, Gs^Fp
Mm, Hh, Gs^Fp, Ww, Ww, Ww, Ww, Ww, Gs^Fp, Wo, Hh, Ww, Hh, Gs^Fp, Gg, Gs^Fp, Hh, Mm, Mm, Mm, Gg, Gs^Fp, Mm, Mm
Gg, Gg, Gg, Hh, Wo, Wo, Wo, Ww, Gg, Gg, Gg, Hh, Gs^Fp, Gg, Gs^Fp, Gs^Fp, Mm, Mm, Hh, Mm, Gg, Hh, Hh, Mm
Wo, Wo, Ww, Ww, Wo, Hh, Mm, Hh^Vhh, Ww, Ww, Ww, Gg, Gg, Gg, Gs^Fp, Hh, Gs^Fp, Gs^Fp, Gs^Fp, Gs^Fp, Gg, Ww, Hh, Hh
Wo, Ww, Hh, Ww, Ww, Hh, Mm, Ww, Wo, Wo, Ww, Hh, Gg, Gg, Gg, Gs^Fp, Gg, Hh, Gg, Gs^Fp, Ww, Wo, Ww, Ww
Ww, Ww, Gg, Gg, Hh, Mm, Mm, Hh, Wo, Ww, Hh, Hh, Gs^Fp, Gg, Gg, Ww^Wkf, Ss, Gs^Fp, Isa, Gg, Hh, Ww, Gg, Wo
Hh, Mm, Ww, Wo, Gg, Hh, Ww, Wo, Ww, Ww, Gg, Gs^Fp, Mm, Gg, Gs^Fp, Ss, Ss, Isa, Isa, Isr, Chr, Isa, Ww, Gg
Gs^Fp, Hh, Mm, Ww, Gg, Gs^Fp, Hh, Ww, Hh, Ww, Gg, Ww, Hh, Gg, Ss, Ss, Isa, Hh, Isa, Isa, Isa, Hh, Hh, Hh
Gg, Hh, Hh, Gs^Fp, Gg, Ww, Gg, Ww, Gg, Gs^Fp, Gs^Fp, Hh, Gg, Gg, Ss, Ss, Isa, Rp^Vhcr, Chr, Isr, Isr, Mm, Hh, Gs^Fp
Gs^Fp, Gg, Gg, Gg, Gg, Gg, Gs^Fp, Gs^Fp, Gs^Fp, Gg, Gg, Gg, Ss, Isa, Rp^Vhcr, Isr, Isr, Isa, 2 Khr, Chr, Isr, Isa, Isa, Gs^Fp
Gs^Fp, Gs^Fp, Gg, Gs^Fp, Hh, Hh, Hh, Gs^Fp, Gg, Gg, Gg, Gs^Fp, Ss, Isa, Hh, Isa, Isr, Chr, Chr, Chr, Isr, Isa, Ss, Isa
Hh, Hh, Mm, Mm, Mm, Mm, Mm, Mm, Hh, Gs^Vo, Hh, Gg, Gg, Ss, Ww^Wkf, Ss, Gs^Fp, Isa, Isa, Isa, Isa, Ss, Ss, Gs^Fp
Mm, Mm, Mm, Mm, Mm, Mm, Mm, Mm, Mm, Gg, Hh, Hh, Hh, Gg, Gg, Gg, Ss, Ss, Ss, Ss, Ss, Ss, Ss, Ss
Hh, Mm, Mm, Mm, Mm, Mm, Mm, Mm, Gs^Fp, Gg, Gg, Gs^Fp, Gg, Gg, Hh, Gg, Gg, Isa, Rp^Vhcr, Ss, Ss, Ss, Gs^Fp, Ss
Mm, Mm, Mm, Mm, Hh, Hh, Hh, Hh, Gs^Fp, Gs^Fp, Gg, Gg, Gg, Gg, Gg, Gg, Gs^Fp, Gg, Gs^Fp, Ww^Wkf, Ss, Gg, Gs^Fp, Gs^Fp
Hh, Mm, Hh, Gg, Gs^Fp, Gs^Fp, Gs^Fp, Hh, Gg, Gg, Hh, Gs^Fp, Hh, Gg, Hh, Hh, Hh, Gg, Gs^Fp, Hh, Gg, Gg, Gg, Hh
Mm, Gs^Fp, Gg, Gs^Fp, Hh, Gs^Fp, Gg, Gs^Fp, Mm, Gg, Mm, Hh, Hh, Gg, Gs^Fp, Mm, Gg, Gg, Gg, Gs^Fp, Gg, Hh, Gg, Hh
Gs^Fp, Gg, Mm, Mm, Hh, Gg, Gs^Fp, Gs^Fp, Hh, Mm, Mm, Mm, Mm, Hh, Gg, Gg, Gs^Fp, Gg, Mm, Mm, Mm, Gg, Ww, Gg
Gs^Fp, Gs^Fp, Gs^Fp, Mm, Gg, Gg, Gg, Gs^Fp, Gg, Gg, Gs^Fp, Hh, Gs^Fp, Hh, Gg, Gs^Fp, Gs^Fp, Gg, Gg, Mm, Hh, Hh, Wo, Ww
Hh, Gs^Fp, Gs^Fp, Gg, Ww, Ww, Ww, Gg, Ww, Gg, Gg, Gs^Fp, Gs^Fp, Gg, Wwf, Hh, Wo, Ww, Wwf, Hh, Hh, Ww, Wo, Wo
Gs^Fp, Hh, Gg, Gg, Gs^Fp, Gg, Gg, Gg, Ww, Wo, Gg, Gg, Gs^Fp, Gs^Fp, Wwf, Hh, Ww, Ww, Hh, Ww, Ww, Ww, Ww, Ww
Gg, Hh, Gs^Fp, Gs^Fp, Ww, Hh, Hh, Gs^Fp, Hh, Ww, Ww, Gg, Wo, Ww, Wwf, Wwf, Ww, Gg, Gg, Gg, Gg, Hh, Hh, Hh
Gg, Gg, Gg, Gs^Fp, Ww, Ww, Ww, Wo, Ww, Hh, Ww, Ww, Ww, Ww, Gg, Gg, Gg, Hh, Gg, Ww, Gg, Hh, Gs^Fp, Gg
Hh, Gg, Mm, Gg, Gg, Hh, Mm, Ww, Gs^Fp, Gg, Gs^Fp, Gg, Gs^Fp, Hh, Gg, Wwf, Ww, Gg, Gs^Vh, Gg, Gg, Gs^Fp, Gs^Fp, Hh
Hh, Hh, Mm, Hh, Gg, Gg, Gg, Gg, Gg, Gg, Hh, Gs^Fp, Gg, Gs^Fp, Gg, Ww, Hh, Gg, Gg, Hh, Hh, Gg, Gg, Gg
Mm, Mm, Mm, Mm, Gg, Hh, Mm, Mm, Mm, Gg, Gg, Hh, Gg, Gg, Hh, Gg, Ket, Ce, Gg, Mm, Mm, Hh, Gs^Fp, Gg
Gg, Gg, Gg, Hh, Gs^Fp, Mm, Hh, Mm, Hh, Hh, Gg, Gs^Fp, Gg, Hh, Hh, Gg, Gg, Ce, Gg, Hh, Mm, Hh, Hh, Gg
Mm, Hh, Mm, Gs^Fp, Gs^Fp, Gs^Fp, Gs^Fp, Hh, Gs^Fp, Gs^Fp, Hh, Gg, Hh, Hh, Gs^Fp, Gg, Gg, Gs^Fp, Hh, Mm, Mm, Mm, Gg, Gg
Mm, Mm, Mm, Mm, Gg, Gs^Fp, Gg, Gg, Gg, Gs^Fp, Gg, Gg, Hh, Hh, Gs^Fp, Gs^Fp, Gg, Gg, Gg, Hh^Vhh, Gg, Mm, Gg, Hh
Hh, Hh, Hh, Mm, Gg, Gg, Gs^Fp, Gg, Ww, Gg, Gs^Fp, Gg, Gg, Mm, Gg^Ve, Gg, Ce, Ce, Ce, Gg, Ce, Gg, Hh, Hh
Gs^Fp, Hh, Gs^Fp, Gg, Hh, Hh, Gs^Fp, Hh, Wo, Hh, Ww, Gg, Gg, Gg, Gg, Gs^Fp, Ce, 1 Ket, Ce, Gg, Gs^Fp, Gs^Fp, Gg, Mm
Gg, Gg, Gs^Fp, Gg, Mm, Hh, Gg, Ww, Ww, Ww, Hh, Ww, Gg, Hh, Gs^Fp, Gg, Hh, Ce, Gg, Gg, Gs^Fp, Gs^Fp, Hh, Gg
Hh, Gs^Fp, Hh, Hh, Mm, Mm, Hh, Gs^Fp, Gg, Gg, Gg, Gg, Gs^Fp, Gs^Fp, Gs^Fp, Gs^Fp, Gs^Fp, Gg, Gg, Gs^Fp, Gs^Fp, Gs^Fp, Gs^Fp, Hh
