Mm, Hh, Aa, Aa, Hh, Mm, Mm, Mm, Mm, Mm, Hh, Hh, Mm^Xm, Hh, Gg, Hh, Gg, Mm, Mm, Wo, Ww, Ww, Ww, Hh
Hh, Hh, Gg, Gs^Fp, Hh^Fp, Hh, Mm, Mm, Mm^Xm, Mm, Mm, Mm, Mm, Mm, Hh, Gs^Fp, Gg, Hh, Ww, Ww, Hh, Wo, Wo, Ww
Ww, Ww, Gg, Gs^Fp, Gs, Gg, Gg, Mm, Mm, Mm^Xm, Mm, Mm, Gg, Mm, Gg, Hh^Fp, Ww, Ai, Aa, Gs^Fp, Hh^Fp, Hh, Wo, Wo
Hh, Aa, Gg, Gs, Gg, Gg, Gs^Fp, Hh, Hh, Mm, Hh, Hh, Hh, Gg, Gs^Fp, Ww, Ww, Aa, Hh, Gg, Gs^Fp, Gg, Ww, Ww
Gs^Fp, Hh^Fp, Gg, Gg, Gg, Gg, Gg, Hh, Aa, Hh, Hh^Fp, Hh^Fp, Gs^Fp, Gg, Gg, Hh, Ai, Gg, Hh, Hh^Vhh, Hh, Gg, Hh^Fp, Hh
Gg, Gs^Fp, Gg, Hh, Aa, Gg, Gg, Gg, Gs^Fp, Gg, Gg, Gs^Fp, Gg, Gg, Hh, Gg, Hh, Aa, Gs^Fp, Gg, Gg, Aa, Gs^Fp, Hh^Fp
Hh, Gg, Gs^Fp, Aa, Ww, Aa, Gg, Gg, Gg, Hh^Fp, Aa, Gg, Gs^Fp, Hh^Fp, Mm, Hh, Mm, Hh, Hh, Hh, Mm, Gg, Aa, Aa
Hh, Mm, Mm, Hh, Hh^Fp, Hh, Gd, Gg, Ww, Hh, Ww, Aa, Gg, Hh, Mm, Mm, Mm, Mm, Mm, Mm, Mm, Hh, Hh, Gs^Fp
Mm, Hh, Mm, Mm, Hh, Gg, Gg, Gg, Gg, Wo, Aa, Gg, Hh, Hh^Vhh, Mm, Mm, Mm, Mm, Mm, Mm, Mm, Mm, Mm, Hh
Hh, Mm, Mm, Mm^Xm, Mm, Gs^Fp, Hh, Gg, Ww, Ww, Gg, Gs^Fp, Mm, Mm, Mm, Mm^Xm, Mm, Mm, Mm^Xm, Mm, Hh, Mm, Mm, Mm^Xm
Mm, Mm, Mm, Mm, Mm, Hh^Fp, Hh^Fp, Gg, Mm, Hh, Gs^Fp, Mm, Mm, Mm, Mm, Mm, Mm, Mm, Mm, Mm, Mm, Mm, Mm, Mm
Mm^Xm, Mm, Mm, Mm, Hh^Fp, Hh^Fp, Gs^Fp, Gg, Gg, Gg, Gs^Fp, Hh, Hh^Fp, Hh, Hh, Mm, Mm, Mm, Mm^Xm, Mm^Xm, Mm^Xm, Mm^Xm, Mm, Hh
Mm, Mm, Mm, Hh, Gs^Fp, Hh, Gg, Gg, Gd, Gg, Gg, Gs^Fp, Gg, Hh^Fp, Hh, Mm, Hh, Mm, Mm, Mm, Mm, Mm, Hh, Mm
Hh, Hh, Hh, Hh, Gg, Gs^Fp, Gs^Fp, Gg^Ve, Gg, Gg, Gg, Ww, Gg, Hh, Gs^Fp, Gg, Gg, Gg, Gg, Mm, Hh^Fp, Hh, Hh^Fp, Mm
Gs^Fp, Gg, Gs^Fp, Hh^Fp, Ww, Ww, Hh, Gs^Fp, Gg, Ww, Gg, Gg, Gg, Gg, Gs^Vo, Hh, Gg, Hh, Gs^Fp, Hh, Gs^Fp, Hh^Fp, Gg, Hh
Hh, Hh, Gd, Gs^Fp, Gg, Wo, Hh, Hh, Gg, Ww, Ww, Gs, Ww, Gg, Gg, Mm, Gg, Gs^Fp, Hh^Fp, Gg, Gg, Gg, Hh, Hh^Fp
Mm, Hh, Gs, Ww, Ww, Ww, Ww, Ww, Gs, Wo, Hh, Ww, Hh, Gd, Gg, Gs^Fp, Hh, Mm, Mm^Xm, Mm, Gg, Gs^Fp, Mm, Mm
Gg, Gg, Gg, Hh, Wo, Wo, Wo, Ww, Gg, Gg, Gg, Hh, Gd, Gg, Gs^Fp, Gs^Fp, Mm, Mm, Hh, Mm, Gg, Hh, Hh, Mm^Xm
Wo, Wo, Ww, Ww, Wo, Hh, Mm, Hh^Vhh, Ww, Ww, Wwf, Gg, Gg, Gg, Hh^Fp, Hh, Mm, Hh^Fp, Hh^Fp, Gs^Fp, Gg, Ww, Hh, Hh
Wo, Ww, Hh, Ww, Ww, Hh, Mm^Xm, Ww, Wo, Wo, Wwf^Dr, Hh, Gg, Gg, Gg, Gs^Fp, Gg, Hh, Gg, Gs^Fp, Ww, Wo, Ww, Ww
Ww, Ww, Gg, Gg, Hh, Mm, Mm, Hh, Wo, Ww, Hh, Hh, Gs, Gg, Gg, Ww^Wkf, Ss, Hh, Isa, Gg, Hh, Ww, Gg, Wo
Hh, Mm, Ww, Wo, Gg, Hh, Ww, Wo, Ww, Ww, Gs, Gd, Mm, Gg, Gs^Fp, Ss, Ss, Isa, Isa, Isr, Chr, Isa, Ww, Gg
Gs^Fp, Hh, Mm, Ww, Gg, Gs^Fp, Hh, Ww, Hh, Wwf, Gg, Ww, Hh, Gg, Ss, Ss, Isa, Hh, Isa, Isa, Isa, Hh, Hh, Hh
Gg, Hh, Hh, Gs^Fp, Gg, Ww, Gg, Ww, Gg, Gs^Fp, Gs^Fp, Hh, Gg, Gg, Ss, Ss, Isa, Rp^Vhcr, Chr, Isr, Isr, Mm, Hh, Gs^Fp
Gs^Fp, Gg, Gg, Gg, Gg, Gg, Gs^Fp, Gs^Fp, Hh^Fp, Gg, Gg, Gg, Ss, Isa, Rp^Vhcr, Isr, Isr, Isa, 2 Khr, Chr, Isr, Isa, Isa, Gs^Fp
Hh^Fp, Gs^Fp, Hh, Gs, Hh, Hh, Hh, Hh^Fp, Gg, Gg, Gg, Gs^Fp, Ss, Isa, Hh, Isa, Isr, Chr, Chr, Chr, Isr, Isa, Ss, Isa
Hh, Hh, Mm, Mm, Mm, Mm^Xm, Mm, Mm, Hh, Gs^Vo, Hh, Gg, Gg, Ss, Ww^Wkf, Ss, Gs^Fp, Isa, Isa, Isa, Isa, Ss, Ss, Gs^Fp
Mm, Mm, Mm^Xm, Mm, Mm, Mm, Mm, Mm, Mm, Gg, Hh, Hh, Hh, Gg, Gg, Gg, Ss, Ss, Ss, Ss, Ss, Ss, Ss, Ss
Hh, Mm^Xm, Mm, Mm^Xm, Mm, Mm, Mm, Mm, Hh^Fp, Gg, Gg, Hh^Fp, Gg, Gg, Hh, Gg, Gg, Isa, Rp^Vhcr, Ss, Ss, Ss, Gs^Fp, Ss
Mm, Mm, Mm, Mm, Hh, Hh, Hh, Hh, Hh^Fp, Gs^Fp, Gg, Gg, Gg, Gg, Gg, Gg, Gs^Fp, Gg, Gs^Fp, Ww^Wkf, Ss, Gg, Hh^Fp, Gs^Fp
Hh, Mm, Hh, Gg, Hh^Fp, Hh^Fp, Gs^Fp, Hh, Gg, Gg, Hh, Gs^Fp, Hh, Gg, Hh, Hh, Hh, Gg, Hh^Fp, Hh, Gg, Gg, Gg, Hh
Mm, Gs^Fp, Gg, Gs^Fp, Hh, Hh^Fp, Gg, Gs^Fp, Mm, Gg, Mm, Hh, Hh, Gg, Gs^Fp, Mm, Gg, Gg, Gg, Gs^Fp, Gg, Hh, Gg, Hh
Gs^Fp, Gg, Mm^Xm, Mm, Hh, Gg, Gs^Fp, Hh^Fp, Hh, Mm, Mm, Mm^Xm, Mm, Hh, Gg, Gg, Gs^Fp, Gg, Mm, Mm^Xm, Mm, Gg, Ww, Gg
Gs^Fp, Gs^Fp, Hh^Fp, Mm, Gg, Gg, Gg, Gs^Fp, Gg, Gg, Gs^Fp, Hh, Gs^Fp, Hh, Gg, Gs^Fp, Gs^Fp, Gg, Gg, Mm, Hh, Hh, Wo, Ww
Hh, Hh^Fp, Gs^Fp, Gg, Ww, Ww, Ww, Gg, Ww, Gg, Gg, Gs^Fp, Hh^Fp, Gg, Wwf, Hh, Wo, Ww, Wwf, Hh, Mm, Ww, Wo, Wo
Gs^Fp, Hh, Gg, Gg, Gs, Gg, Gg, Gg, Ww, Wo, Gg, Gg, Gs^Fp, Gs^Fp, Wwf^Dr, Hh, Ww, Ww, Hh, Ww, Ww, Ww, Ww, Ww
Gg, Hh, Gs^Fp, Gs^Fp, Ww, Hh, Hh, Gs^Fp, Hh, Ww, Ww, Gg, Wo, Ww, Wwf, Wwf, Ww, Gg, Gg, Gg, Gg, Hh, Hh, Hh
Gs^Fp, Gg, Gg, Hh^Fp, Ww, Ww, Ww, Wo, Ww, Hh, Ww, Ww, Ww, Ww, Gg, Gg, Gg, Hh, Gg, Ww, Gg, Hh, Hh^Fp, Gg
Hh^Fp, Gg, Mm, Gg, Gg, Hh, Mm, Ww, Gs, Gg, Gs^Fp, Gg, Gs^Fp, Hh, Gg, Wwf, Ww, Gg, Gs^Vh, Gg, Gg, Gs^Fp, Gs^Fp, Hh
Hh, Hh, Mm, Hh, Gg, Gg, Gg, Gg, Gg, Gg, Hh, Hh^Fp, Gg, Gs^Fp, Gg, Ww, Hh, Gg, Gg, Hh, Hh^Fp, Gg, Gg, Gg
Mm, Mm, Mm, Mm, Gg, Hh, Mm, Mm, Mm, Gg, Gg, Hh, Gg, Gg, Hh, Gg, Ket, Ce, Gg, Mm, Mm^Xm, Hh, Gs^Fp, Gg
Gg, Gg, Gg, Hh, Gs^Fp, Mm^Xm, Hh, Mm, Hh, Hh, Gg, Gs^Fp, Gg, Hh, Hh, Gg, Gg, Ce, Gg, Hh, Mm^Xm, Hh, Hh^Fp, Gg
Mm, Hh, Mm, Gs^Fp, Gs^Fp, Gs^Fp, Hh^Fp, Hh, Hh^Fp, Hh^Fp, Hh, Gg, Hh, Hh, Gs^Fp, Gg, Gg, Gs^Fp, Hh, Mm, Mm, Mm, Gg, Gg
Mm, Mm, Mm, Mm^Xm, Gg, Gs^Fp, Gg, Gg, Gg, Gs^Fp, Gg, Gg, Hh, Hh, Hh^Fp, Gs^Fp, Gg, Gg, Gg, Hh^Vhh, Gg, Mm, Gg, Hh
Hh, Hh, Hh, Mm, Gg, Gg, Gs^Fp, Gg, Ww, Gg, Gs^Fp, Gg, Gg, Mm, Gg^Ve, Gg, Ce, Ce, Ce, Gg, Ce, Gg, Hh, Hh
Gs^Fp, Hh, Gs^Fp, Gg, Hh, Hh, Hh^Fp, Hh, Wo, Hh, Ww, Gg, Gg, Gg, Gg, Gs^Fp, Ce, 1 Ket, Ce, Gg, Hh^Fp, Gs^Fp, Gg, Mm
Gg, Gg, Gs^Fp, Gg, Mm, Hh, Gg, Ww, Ww, Ww, Hh, Ww, Gg, Hh, Hh^Fp, Gg, Hh, Ce, Gg, Gg, Gs^Fp, Gs^Fp, Hh, Gg
Hh, Hh^Fp, Hh, Hh, Mm, Mm^Xm, Hh, Gs^Fp, Gg, Gg, Gg, Gg, Hh, Gs^Fp, Hh^Fp, Hh^Fp, Gs^Fp, Gg, Gg, Gs^Fp, Hh^Fp, Hh^Fp, Hh^Fp, Hh
