Xos, Xos, Xos, Xos, Xos, Xos, Xos, Xos, Isr, Isr, Xos, Xos, Xos, Xos, Xos, Xos, Xos, Xos, Xos, Xos, Xos, Xos
Xos, Xos, Xos, Xos, Xos, Xos, Xos, Xos, Isr^Es, Isr^Ii, Xos, Xos, Xos, Xos, Xos, Xos, Xos, Xos, Xos, Xos, Xos, Xos
Xos, Xos, Xos, Xos, Xuf, Xos, Xos, Xos, Isr^Es, Wo, Xos, Xos, Xos, Xos, Xos, Xos, Xos, Xos, Xos, Xos, Xos, Xos
Xos, Xos, Xos, Xuf, Isr^Fetd, Xos, Xos, Xuf, Iwo, Iwo, Xuf, Xos, Xos, Xos, Xos, Xos, Xos, Xos, Xos, Xos, Xos, Xos
Xos, Xos, Xos, Isr, Isc^Kov, Isr^Em, Isr^Es, Iwo, Qlf, Isr^Es, Isr^Fet, Xos, Xos, Xos, Xos, Xos, Xos, Xos, Xos, Xos, Xos, Xos
Xos, Xos, Xos, Qlf, Isr, Isr^Cov, Ur^Edb, Ur^Edb, Ur^Em, Isr, Wo, Ur^Emf, Ur^Tf, Xuf, Xos, Xos, Xos, Xos, Xos, Xos, Xos, Xos
Xos, Xos, Xos, Xos, Isr, Qlf, Isa, Isr, Isa^Edb, Chr, Isa, Ur^Em, Isa^Em, Isa, Isr, Xuf, Xuf, Xos, Xos, Xos, Xos, Xos
Xos, Xos, Xos, Xos, Xos, Qlf, Chr, Isa, Isa^Edb, Isa^Edb, Isa, Isr, Isa, Qlf, Isr, Isr, Isr, Xos, Xos, Xos, Xos, Xos
Xos, Xos, Xos, Xos, Xos, Xos, Xuf, Isr, Qlf, Isa^Edb, Isa, Isa, Khr, Chr, Isr^Em, Qlf, Qlf, Xos, Xos, Xos, Xos, Xos
Xos, Xos, Xos, Xos, Xos, Xos, Xos, Isr, Isr, Isa, Isa^Edb, Isa^Edb, Ur^Edb, Ur^Tf, Ur^Emf, Qlf, Ur^Edb, Xos, Xos, Xos, Xos, Xos
Xos, Xos, Xos, Xos, Xos, Xos, Xos, Isr^Em, Isr^Ii, Ur, Isa^Edb, Isa^Edb, Isa, Wo, Isa, Isa, Chr, Xos, Xos, Xos, Xos, Xos
Xos, Xos, Xos, Xos, Xos, Xos, Xos, Qlf, Qlf, Isa^Edb, Isa^Edb, Isa, Isa^Edb, Isa, Isr^Ii, Isr, Xuf, Xos, Xos, Xos, Xos, Xos
Xos, Xos, Xos, Xos, Xos, Xos, Xos, Xos, Xos, Ur^Em, Isa^Em, Isr, 1 Isr^Es, Iwo, Wo, Isr^Em, Xos, Xos, Xos, Xos, Xos, Xos
Xos, Xos, Xos, Xos, Xos, Xos, Xos, Xos, Xos, Xos, Xos, Isa^Ii, Iwo, Iwo, Xos, Xos, Xos, Xos, Xos, Xos, Xos, Xos
Xos, Xos, Xos, Xos, Xos, Xos, Xos, Xos, Xos, Xos, Xos, Isr^Ii, Isr, Isr, Xuf, Xos, Xos, Xos, Xos, Xos, Xos, Xos
Xos, Xos, Xos, Xos, Xos, Xos, Xos, Xos, Xos, Xos, Xos, Isr, Isr, Isr, Xuf, Xos, Xos, Xos, Xos, Xos, Xos, Xos
