Qxua^Xo, Qxua^Xo, Qxua^Xo, Qxua^Xo, Qxua^Xo, Qxua^Xo, Qxua^Xo, Qxua^Xo, Qxua^Xo, Qxua^Xo, Qxua^Xo, Qxua^Xo, Qxua^Xo, Qxua^Xo, Qxua^Xo, Qxua^Xo, Qxua^Xo, Qxua^Xo, Qxua^Xo, Qxua^Xo, Qxua^Xo, Qxua^Xo, Qxua^Xo, Qxua^Xo, Qxua^Xo, Qxua^Xo, Qxua^Xo, Qxua^Xo, Qxua^Xo, Qxua^Xo, Qxua^Xo, Qxua^Xo, Qxua^Xo, Qxua^Xo, Qxua^Xo, Qxua^Xo, Qxua^Xo, Qxua^Xo
Qxua^Xo, Qxua^Xo, Qxua^Xo, Qxua^Xo, Qxua^Xo, Qxua^Xo, Qxua^Xo, Qxua^Xo, Aa, Qxua^Xo, Aa, Qxua^Xo, Aa, Qxua^Xo, Qxua^Xo, Qxua^Xo, Qxua^Xo, Qxua^Xo, Qxua^Xo, Qxua^Xo, Qxua^Xo, Qxua^Xo, Aa, Qxua^Xo, Qxua^Xo, Qxua^Xo, Qxua^Xo, Qxua^Xo, Qxua^Xo, Qxua^Xo, Aa, Qxua^Xo, Qxua^Xo, Qxua^Xo, Qxua^Xo, Qxua^Xo, Qxua^Xo, Qxua^Xo
Qxua^Xo, Qxua^Xo, Qxua^Xo, Qxua^Xo, Qxua^Xo, Qxua^Xo, Qxua^Xo, Aa, Xv, Aa, Wo, Aa, Wo, Aa, Qxua^Xo, Qxua^Xo, Qxua^Xo, Qxua^Xo, Qxua^Xo, Qxua^Xo, Aa, Aa, Mm, Aa, Aa, Qxua^Xo, Aa, Aa, Aa, Aa, Mm, Aa, Aa, Qxua^Xo, Qxua^Xo, Qxua^Xo, Qxua^Xo, Qxua^Xo
Qxua^Xo, Qxua^Xo, Qxua^Xo, Qxua^Xo, Qxua^Xo, Qxua^Xo, Qxua^Xo, Aa, Aa, Wo, Ww, Wo^Ii, Aa, Aa, Qxua^Xo, Qxua^Xo, Qxua^Xo, Qxua^Xo, Qxua^Xo, Qxua^Xo, Aa, Mm^Xm, Hh^Fms, Gs^Fds, Gs^Fds, Aa, Hh^Fds, Mm, Mm^Xm, Mm, Mm, Mm, Mm^Xm, Aa, Qxua^Xo, Qxua^Xo, Qxua^Xo, Qxua^Xo
Qxua^Xo, Qxua^Xo, Qxua^Xo, Qxua^Xo, Aa, Aa, Aa, Qxua^Xo, Qxua^Xo, Aa, Aa, Aa, Qxua^Xo, Qxua^Xo, Aa, Qxua^Xo, Qxua^Xo, Qxua^Xo, Qxua^Xo, Qxua^Xo, Aa, Mm, Hh, Gs^Fds, Gs^Fds, Hh^Fms, Gs^Fds, Mm, Hh^Em, Mm^Xm, Mm, Mm, Hh^Fds, Aa, Qxua^Xo, Qxua^Xo, Qxua^Xo, Qxua^Xo
Qxua^Xo, Qxua^Xo, Aa, Aa, Wo, Wo, Wo, Aa, Aa, Qxua^Xo, Qxua^Xo, Qxua^Xo, Aa, Aa, Gs^Fds, Aa, Aa, Qxua^Xo, Qxua^Xo, Qxua^Xo, Aa, Hh^Fds, Gs^Fms, Mm, Gg^Efm, Gs^Fms, Gg^Ve, Gs^Fds, Gs^Efm, Gs^Fds, Hh^Fms, Hh, Gs^Fms, Aa, Aa, Qxua^Xo, Qxua^Xo, Qxua^Xo
Qxua^Xo, Qxua^Xo, Aa, Xv, Ww^Wkf, Wwr, Wwf, Wo, Aa, Qxua^Xo, Aa, Aa, Mm^Xm, Gs^Fds, Ce^Ii, Hh^Fms, Gs^Fds, Aa, Qxua^Xo, Aa, Mm, Hh, Hh^Fds, Hh^Fds, Gs^Fds, Gs, Hh^Fms, Gg, Gg, Gg^Efm, Gg^Edb, Gg^Es, Gd, Hh^Em, Aa, Qxua^Xo, Qxua^Xo, Qxua^Xo
Qxua^Xo, Qxua^Xo, Aa, Wo, Ww, Ds, Ww^Wkf, Wo, Aa, Qxua^Xo, Aa, Mm^Xm, Mm, Ce^Em, Ke, Ce^Ii, Hh^Em, Aa, Qxua^Xo, Aa, Mm^Xm, Mm, Gd^Fetd, Gg^Em, Gg, Gs^Efm, Gs, Gs^Fms, Gg, Mm, Gs^Fms, Gs^Fds, Mm, Mm^Xm, Aa, Qxua^Xo, Qxua^Xo, Qxua^Xo
Qxua^Xo, Qxua^Xo, Aa, Wo, Wwf^Es, Ww, Ww^Wkf, Wo, Aa, Qxua^Xo, Aa, Hh^Fms, Hh^Fds, Ce^Em, Ce, Ce^Efs, Gg^Fet, Aa, Qxua^Xo, Aa, Wwf, Gll^Fdw, Sm, Ww^Wkf, Gll^Fmw, Gg^Efm, Gg^Es, Gg^Efm, Gg, Gs^Em, Gd^Emf, Hh^Fms, Hh^Fds, Mm, Aa, Qxua^Xo, Qxua^Xo, Qxua^Xo
Qxua^Xo, Qxua^Xo, Aa, Wo, Wwr, Ww, Ww, Xv, Aa, Qxua^Xo, Aa, Gs^Fds, Gs^Es, Gg^Efm, Gs, Gs^Fds, Gs^Fdw, Aa, Qxua^Xo, Aa, Wwf, Ss, Ss, Ss, Sm, Gll^Fmw, Gll^Fdw, Gs^Edb, Gs, Gg, Gg^Em, Gs^Em, Hh^Em, Gs^Fms, Aa, Qxua^Xo, Qxua^Xo, Qxua^Xo
Qxua^Xo, Qxua^Xo, Aa, Wo, Ds, Ww^Wkf, Aa, Aa, Qxua^Xo, Qxua^Xo, Aa, Gd, Gg^Efm, Gs^Fds, Ce^Ii, Gg^Efm, Mm, Aa, Qxua^Xo, Aa, Aa, Aa, Aa, Wwf, Ss, Sm, Ww^Wkf, Gd^Em, Hh^Fmw, Gll^Fmw, Gs, Gs^Vl, Gg^Efm, Mm, Aa, Qxua^Xo, Qxua^Xo, Qxua^Xo
Qxua^Xo, Qxua^Xo, Aa, Wo, Ww, Wwr, Aa, Qxua^Xo, Aa, Aa, Gs^Fms, Gg^Ii, Hh^Fds, Ce^Es, Ke, Ce, Hh, Aa, Qxua^Xo, Qxua^Xo, Qxua^Xo, Qxua^Xo, Qxua^Xo, Aa, Aa, Gll^Fmw, Gg^Efm, Gs^Fms, Gs, Gg^Efm, Gg, Gg, Gs^Em, Gs^Em, Aa, Qxua^Xo, Qxua^Xo, Qxua^Xo
Qxua^Xo, Qxua^Xo, Aa, Wo, Wo, Xv, Aa, Qxua^Xo, Aa, Gs^Fds, Hh^Em, Gg^Ve, Gg^Fet, Ce, Gg^Es, Gs^Fds, Aa, Aa, Qxua^Xo, Qxua^Xo, Aa, Aa, Aa, Qxua^Xo, Qxua^Xo, Aa, Aa, Ww^Wkf, Ss, Gll^Fdw, Gll^Fmw, Gg, Gg, Gd^Emf, Aa, Qxua^Xo, Qxua^Xo, Qxua^Xo
Qxua^Xo, Qxua^Xo, Qxua^Xo, Aa, Aa, Aa, Qxua^Xo, Qxua^Xo, Aa, Gg^Efm, Gs, Gg^Efm, Mm, Gs^Fds, Aa, Aa, Qxua^Xo, Qxua^Xo, Aa, Aa, Aa^Fetd, Aa^Fetd, Wo^Fet, Aa, Aa, Qxua^Xo, Aa, Ss, Ss, Sm, Gll^Fmw, Gg^Ii, Gg, Hh, Aa, Qxua^Xo, Qxua^Xo, Qxua^Xo
Qxua^Xo, Qxua^Xo, Qxua^Xo, Qxua^Xo, Qxua^Xo, Qxua^Xo, Aa, Aa, Gs^Fdw, Gg^Ii, Gs^Fdw, Gd^Em, Hh, Mm^Xm, Aa, Qxua^Xo, Aa, Aa, Aa^Fetd, Aa^Fetd, Xv^Fet, Xv^Fet, Aa^Fetd, Aa^Fetd, Aa, Qxua^Xo, Qxua^Xo, Aa, Aa, Ss, Wwf, Gs^Em, Aa, Aa, Qxua^Xo, Qxua^Xo, Qxua^Xo, Qxua^Xo
Qxua^Xo, Qxua^Xo, Qxua^Xo, Qxua^Xo, Aa, Aa, Ww^Wkf, Ds, Ds, Gd^Es, Gs^Fds, Gg^Fet, Aa, Aa, Qxua^Xo, Qxua^Xo, Aa, Aa^Fetd, Wo^Fet, Xv^Fet, Aa^Fetd, Aa^Fetd, Aa^Ii, Aa^Ii, Wo^Fet, Aa, Aa, Qxua^Xo, Qxua^Xo, Aa, Aa, Aa, Qxua^Xo, Qxua^Xo, Qxua^Xo, Qxua^Xo, Qxua^Xo, Qxua^Xo
Qxua^Xo, Qxua^Xo, Aa, Aa, Wo^Ii, Wo, Wo, Ww^Wkf, Ww, Wwf^Es, Aa, Aa, Qxua^Xo, Qxua^Xo, Aa, Aa, Ww, Aa^Ii, Aa, Aa^Fetd, Aa, Aa^Esa, Wo^Fet, Xv^Fet, Aa^Fetd, Aa^Fetd, Wo^Feta, Aa, Aa, Qxua^Xo, Qxua^Xo, Qxua^Xo, Qxua^Xo, Qxua^Xo, Qxua^Xo, Qxua^Xo, Qxua^Xo, Qxua^Xo
Qxua^Xo, Qxua^Xo, Aa, Xv^Ii, Wo^Ii, Wo, Wo, Wo, Aa, Aa, Qxua^Xo, Qxua^Xo, Aa, Aa, Wo^Ii, Aa, Aa, Wo, Aa, Xv, Wo, Aa, Aa^Efm, Aa^Fetd, Wo^Feta, Xv^Feta, Aa, Aa, Aa, Qxua^Xo, Qxua^Xo, Qxua^Xo, Qxua^Xo, Qxua^Xo, Qxua^Xo, Qxua^Xo, Qxua^Xo, Qxua^Xo
Qxua^Xo, Qxua^Xo, Aa, Xv, Xv, Wo, Aa, Aa, Qxua^Xo, Qxua^Xo, Qxua^Xo, Qxua^Xo, Aa, Wo, Xv, Aa^Esa, Wo^Ii, Aa^Ii, Aa^Efm, Ww, Aa^Esa, Wo^Ii, Aa^Efm, Aa^Efm, Aa, Aa, Qlf^Ii, Qlf^Fds, Aa, Aa, Aa, Qxua^Xo, Aa^Dr, Qxua^Xo, Qxua^Xo, Qxua^Xo, Qxua^Xo, Qxua^Xo
Qxua^Xo, Qxua^Xo, Qxua^Xo, Aa, Aa, Aa, Qxua^Xo, Qxua^Xo, Aa, Aa, Aa, Qxua^Xo, Qxua^Xo, Aa, Aa, Aa, Ww, Wo, Aa^Esa, Aa^Efm, Aa, Aa^Ii, Wo, Aa^Esa, Wo, Aa^Ii, Rr^Ii, Qlf, Aa, Aa^Vea, Aa, Aa, Xv, Aa, Aa^Esa, Qxua^Xo, Qxua^Xo, Qxua^Xo
Qxua^Xo, Qxua^Xo, Qxua^Xo, Qxua^Xo, Qxua^Xo, Qxua^Xo, Aa, Aa, Wo, Wo, Wo, Aa, Aa, Qxua^Xo, Aa, Wo, Iwc, Wo, Aa, Aa^Vea, Aa, Wo, Ww, Xv, Aa^Ii, Aa, Aa, Aa, Aa^Esa, Aa, Aa, Ur, Rr^Ii, Aa, Aa, Qxua^Xo, Qxua^Xo, Qxua^Xo
Qxua^Xo, Qxua^Xo, Qxua^Xo, Qxua^Xo, Qxua^Xo, Aa, Wo, Wo, Ww, Ww, Dd^Ftd, Wo, Aa, Qxua^Xo, Qxua^Xo, Aa, Aa, Aa, Qxua^Xo, Aa, Aa, Aa^Dr, Aa, Aa^Efm, Ur, Isa^Ii, Aa, Wo, Aa^Esa, Aa^Efm, Kva, Aa, Isa, Aa^Dr, Aa, Qxua^Xo, Qxua^Xo, Qxua^Xo
Qxua^Xo, Qxua^Xo, Qxua^Xo, Qxua^Xo, Qxua^Xo, Aa, Wo, Wwr, Wwf^Ebn, Ds^Vda, Gs^Ft, Ww, Wwr, Aa, Aa, Qxua^Xo, Qxua^Xo, Qxua^Xo, Qxua^Xo, Qxua^Xo, Qxua^Xo, Aa, Aa, Qlf^Fds, Qlf, Isa, Xv, Aa, Aa, Aa^Efm, Aa^Efm, Aa, Xv, Isa, Aa, Qxua^Xo, Qxua^Xo, Qxua^Xo
Qxua^Xo, Qxua^Xo, Qxua^Xo, Qxua^Xo, Qxua^Xo, Aa, Wo, Ds^Es, Ds^Ebn, Ds^Ecf, Chw, Ww, Wo, Wo, Aa, Qxua^Xo, Qxua^Xo, Qxua^Xo, Qxua^Xo, Qxua^Xo, Qxua^Xo, Aa, Isa, Qlf^Ii, Rr^Ii, Aa, Aa, Aa^Esa, Rr^Ii, Xv, Aa, Aa, Aa, Aa^Esa, Aa^Esa, Qxua^Xo, Qxua^Xo, Qxua^Xo
Qxua^Xo, Qxua^Xo, Qxua^Xo, Qxua^Xo, Qxua^Xo, Aa, Aa, Wo, Wo, Wwf, Wo, Wo, Wo, Wo, Aa, Qxua^Xo, Qxua^Xo, Qxua^Xo, Qxua^Xo, Qxua^Xo, Qxua^Xo, Aa, Aa, Isa, Aa, Aa, Qxua^Xo, Aa, Aa, Ur, Aa^Efm, 1 Cva, Aa, Aa, Qxua^Xo, Qxua^Xo, Qxua^Xo, Qxua^Xo
Qxua^Xo, Qxua^Xo, Qxua^Xo, Qxua^Xo, Qxua^Xo, Qxua^Xo, Qxua^Xo, Aa, Aa, Wo, Aa, Aa, Aa, Aa, Qxua^Xo, Qxua^Xo, Qxua^Xo, Qxua^Xo, Qxua^Xo, Qxua^Xo, Qxua^Xo, Qxua^Xo, Qxua^Xo, Aa, Qxua^Xo, Qxua^Xo, Qxua^Xo, Qxua^Xo, Qxua^Xo, Aa, Aa, Aa, Qxua^Xo, Qxua^Xo, Qxua^Xo, Qxua^Xo, Qxua^Xo, Qxua^Xo
Qxua^Xo, Qxua^Xo, Qxua^Xo, Qxua^Xo, Qxua^Xo, Qxua^Xo, Qxua^Xo, Qxua^Xo, Qxua^Xo, Aa, Qxua^Xo, Qxua^Xo, Qxua^Xo, Qxua^Xo, Qxua^Xo, Qxua^Xo, Qxua^Xo, Qxua^Xo, Qxua^Xo, Qxua^Xo, Qxua^Xo, Qxua^Xo, Qxua^Xo, Qxua^Xo, Qxua^Xo, Qxua^Xo, Qxua^Xo, Qxua^Xo, Qxua^Xo, Qxua^Xo, Qxua^Xo, Qxua^Xo, Qxua^Xo, Qxua^Xo, Qxua^Xo, Qxua^Xo, Qxua^Xo, Qxua^Xo
Qxua^Xo, Qxua^Xo, Qxua^Xo, Qxua^Xo, Qxua^Xo, Qxua^Xo, Qxua^Xo, Qxua^Xo, Qxua^Xo, Qxua^Xo, Qxua^Xo, Qxua^Xo, Qxua^Xo, Qxua^Xo, Qxua^Xo, Qxua^Xo, Qxua^Xo, Qxua^Xo, Qxua^Xo, Qxua^Xo, Qxua^Xo, Qxua^Xo, Qxua^Xo, Qxua^Xo, Qxua^Xo, Qxua^Xo, Qxua^Xo, Qxua^Xo, Qxua^Xo, Qxua^Xo, Qxua^Xo, Qxua^Xo, Qxua^Xo, Qxua^Xo, Qxua^Xo, Qxua^Xo, Qxua^Xo, Qxua^Xo
