Xos, Isa, Isa, Xos, Xos, Xof, Xof, Xof, Hh^Fp, Hh^Fp, Mm, Mm, Mm^Xm, Mm^Xm, Mm, Mm, Mm^Xm, Hh^Fp, Hh^Em, Mm, Mm, Mm, Mm, Mm^Xm, Mm^Xm, Mm, Mm, Mm
Xof, Isa^Edb, Isr, Isa^Ii, Xof, Xof, Xof, Xof, Hh, Hh^Em, Hh^Fp, Mm, Mm, Mm^Xm, Mm, Mm, Mm^Xm, Hh^Fp, Isa, Hh^Vhhr, Mm, Mm^Xm, Mm^Xm, Mm, Mm, Mm^Xm, Mm, Mm
Xof, Xof, Xof, Isa^Edb, Isa^Ii, Xof, Xof, Hh^Fmw, Mm, Mm^Xm, Isa^Dr, Mm, Hh^Es, Mm, Mm, Mm, Hh^Fp, Isa^Es, Isr^Dr, Isa^Em, Mm, Mm, Mm, Mm, Mm, Mm, Mm^Xm, Mm
Xof, Xof, Hh^Edb, Xos, Chr, Xos, Isa^Edb, Rp^Vhcr, Isa^Es, Isa^Edb, Isr^Edb, Rp^Vhcr, Isa^Ii, Hh^Fp, Isa, Hh^Edb, Gd^Edb, Gs^Edb, Gd, Hh^Fmw, Mm, Mm, Mm, Mm, Mm^Xm, Mm, Mm, Mm
Xof, Hh^Fp, Hh^Edb, Chr^Edb, 2 Khr, Chr, Isa^Dr, Isr^Edb, Isr^Ii, Isr, Mm, Isr, Cer^Edb, Isa^Edb, Isr^Edb, Isa, Hh^Fp, Hh, Ww, Hh^Es, Hh^Es, Mm, Mm, Mm, Mm, Mm, Mm, Mm
Hh^Fmw, Hh^Vhhr, Isa^Ii, Chr, Chr^Edb, Chr^Edb, Isa, Isr^Ii, Hh^Fp, Hh, Isr^Dr, Mm, 3 Ker, Cer^Edb, Hh^Em, Isa, Hh^Em, Gs, Ha, Hh^Fp, Ha, Ha, Ha, Hh^Vhh, Hh^Es, Mm, Mm, Mm
Hh^Fp, Mm, Mm^Xm, Isr, Hh, Isa^Edb, Hh, Mm, Isa^Edb, Isa^Ii, Isa^Edb, Cer^Edb, Cer^Edb, Cer, Hh^Fp, Gd^Emf, Gs^Fdw, Gg^Efm, Isa^Edb, Aa, Ai, Aa^Fda, Ai^Esa, Ai, Hh^Fmw, Mm, Mm, Mm
Mm, Mm^Xm, Mm^Xm, Hh^Fp, Mm, Isa, Ww, Gd^Edb, Cer, Gs^Efm, Gd^Es, Gd^Edb, Isa, Hh, Rp^Vhcr, Gd^Em, Gs^Efm, Gs, Aa^Edb, Aa^Fpa, Hh, Hh^Fp, Gs^Fdw, Ww, Aa, Aa^Fda, Hh^Es, Mm
Mm, Mm, Mm, Mm, Mm, Mm^Xm, Hh^Fp, Gd, Hh^Fp, Gs^Fmw, Gs^Em, Isa^Edb, Gg^Efm, Gs, Gg^Efm, Gg^Edb, Gg^Es, Gg^Efm, Hh, Aa, Gd^Vo, Gd^Fp, Aa, Gd^Esa, Ha, Ai, Mm, Aa^Fma
Hh^Fmw, Mm, Hh^Fp, Mm, Mm, Mm, Hh^Em, Isa^Edb, Gg^Efm, Hh^Vhhr, Aa, Gs^Fp, Gd^Fp, Cer, Aa^Esa, Ww, Gs^Fdw, Gg^Es, Gg^Efm, Gs^Edb, Gd^Fp, Aa^Fda, Aa^Esa, Aa^Feta, Mm, Mm, Mm, Mm
Mm, Hh, Mm^Xm, Hh^Fmw, Gd^Fp, Gd^Emf, Gd^Em, Gs^Fdw, Gs^Fmw, Gd^Fp, Hh, Aa, Mm, Gd^Esa, Ai^Esa, Ai, Aa^Fpa, Gd^Fp, Gd, Gg^Fet, Gs^Efm, Aa^Fpa, Gd^Em, Ha^Esa, Ha, Mm, Mm, Mm^Xm
Mm, Mm, Mm, Mm, Mm, Isa, Isa, Cer, Aa, Hh^Fp, Hh^Fp, Mm^Xm, Mm, Hh^Em, Ha, Ai, Aa^Fpa, Aa^Fma, Gs^Fp, Gs, Gg^Es, Gs^Fdw, Hh, Aa^Es, Mm, Mm^Xm, Mm^Xm, Mm
Mm, Mm^Xm, Mm^Xm, Hh, Hh^Vhh, Ha, Aa^Fda, Gs^Fp, Hh^Em, Hh^Em, Mm^Xm, Mm, Mm, Mm^Xm, Mm^Xm, Aa, Hh^Vhh, Aa^Es, Aa, Gg^Efm, Hh^Es, Gg, Gs^Fmw, Gs^Fp, Ai, Mm, Mm, Hh
Mm^Xm, Mm, Mm, Mm, Mm, Ha, Aa, Ai, Ha, Mm, Mm, Mm^Xm, Mm^Xm, Mm, Mm, Mm^Xm, Mm, Ai, Ww, Gd^Vo, Gs, Gg, Mm, Gs, Gd^Esa, Hh^Esa, Aa^Fpa, Mm
Mm^Xm, Mm, Hh^Fp, Mm, Hh^Fp, Ha^Edb, Aa^Fpa, Ai, Ai, Mm^Xm, Mm, Mm, Mm, Mm, Mm^Xm, Mm, Hh, Mm, Gs^Em, Aa^Fma, Hh, Mm, Mm, Hh, Gs^Efm, Aa^Esa, Ai, Hh^Fp
Hh, Mm, Mm, Hh^Es, Mm, Cer^Edb, Cer^Edb, Gd, Gd^Em, Mm^Xm, Mm, Mm, Mm, Mm^Xm, Mm, Hh^Fp, Mm, Mm, Gg^Efm, Aa, Hh^Fp, Mm^Xm, Mm, Mm, Aa, Gg, Hh^Fp, Aa
Hh^Fp, Mm, Hh^Fp, Aa^Fda, Cer, 4 Ker, Cer^Edb, Gs^Fp, Aa, Gg^Fet, Aa, Mm, Hh^Fp, Mm, Gd^Fp, Ha, Gs^Fdw, Gg^Efm, Gs^Fdw, Gg, Gg^Ve, Gs^Fmw, Aa^Esa, Aa^Fda, Hh^Fmw, Gs^Fmw, Hh^Vhh, Ww
Mm^Xm, Hh, Ai, Aa, Ww, Cer^Edb, Gd^Edb, Aa, Cer, Gg^Efm, Gd^Vhr, Gs^Em, Gs^Fmw, Gg^Efm, Hh^Vhh, Gd^Fp, Gs^Fmw, Gg, Aa^Esa, Gd^Esa, Aa^Esa, Gd^Fp, Gg^Efm, Aa^Esa, Ce, Gd^Fp, Gs^Ebn, Mm
Hh, Mm, Aa, Ha, Aa^Fpa, Aa, Ai, Gs^Fp, Hh, Hh^Fp, Mm, Ai, Hh, Gg^Efm, Gg, Hh^Fp, Gs^Em, Aa, Ai, Aa^Fda, Ha, Gs, Gs^Fmw, Ce, 1 Ket, Ce, Aa, Aa^Fpa
Mm, Mm, Mm, Aa^Fma, Aa^Fpa, Aa^Feta, Ha, Aa, Mm^Xm, Mm^Xm, Mm, Hh^Fp, Hh, Aa, Gd, Gg^Em, Gs^Fdw, Gd^Emf, Mm, Mm^Xm, Mm^Xm, Hh^Vhh, Gs^Esa, Ce, Ce, Ce, Ha^Esa, Ai
Mm, Mm, Mm^Xm, Ha, Hh, Aa, Mm^Xm, Mm, Mm, Mm^Xm, Mm, Mm, Mm^Xm, Ha, Aa, Ha, Aa^Fma, Aa^Feta, Hh^Fp, Mm, Mm, Mm, Mm, Hh^Esa, Hh^Fmw, Hh^Fp, Mm, Mm^Xm
Mm, Mm, Mm, Hh, Mm^Xm, Mm, Mm, Mm, Mm, Mm, Mm, Mm, Mm, Mm, Ha, Ai, Ai, Ha, Hh, Mm, Mm, Mm, Mm^Xm, Mm^Xm, Mm, Mm, Mm, Mm
